pirouette		[v]<<French>>（芭蕾舞）用脚尖旋转
slug			[n]鼻涕虫；动作缓慢的人；金属小块；[v]偷懒；动作迟缓；重击
slog			[v]艰苦地干（一段时间）；（用拳）猛击；长途跋涉
rampart			[n]垒；[v]用壁垒围绕，防御
mischievous		[a]淘气的，恶作剧的，有害的
vagrant			[a]流浪的；[n]流浪汉
tinder			[n]易燃物，火绒
tinderbox		[n]易燃物，容易生气的人，潜伏着暴乱危险的人
hemlock			[n]<<botany>>毒芹属植物，铁杉
charmer			[n]魔术师，可爱的人
pulp			[n]纸浆，果肉
nary			[pron]没有，决不
layabout		[n]懒汉，游荡者
wont			[n]习惯；[a]惯常的；[v]习惯于
breakneck		[a]非常危险的，非常快速的
neglect			[v]忽视，忽略
hygiene			[n]卫生学，保健
survey			[n]纵览，审视，勘测
crouch			[v]蹲伏
campsite		[n]营地
garner			[n]谷仓；[v]存入谷仓，收集
laurel			[n]<<botany>>月桂树；[v]授予荣誉
defecate		[v]澄清，排便，除去污物
cretin			[n]白痴
comeuppance		[n]因果报应
fraught			[a]充满......的；担心的，注定导致的，忧虑的
heed			[v]注意，留意
tribunal		[n]审判，法庭，裁决
wallop			[v]痛打，击溃，击败；沸腾，颠簸；[n]巨大影响，冲击；快感；啤酒
gallop			[v]疾驰，飞奔
cubby			[n]小房间
insignia		[n]记号，徽章
apostle			[n]信徒，使徒
strand			[n]海滨；线，串；[v]搁浅；使陷于困境；弄断；使落后
galactic		[a]银河的；乳汁的
rabid			[a]激烈的；狂暴的，患狂犬病的
bungle			[v]笨手笨脚地做，把...弄糟
lull			[v]使平静，平息；使放松警惕
walkie			[n]起重货车
sap				[n]树液；蠢的容易受骗的人；大棒子；[v]吸走树液；[v]捣毁；吸干
ore				[n]矿石
nugget			[n]金块；小块东西；珍品；小圆片食物
callus			[n]皮肤的硬结；植物受伤表秒形成的软组织；[v]
hassle			[n]困难，分歧，起哄；[v]争辩
battue			[n]大量捕杀，用追赶法狩猎，忙乱的集体活动
conjunction		[n]结合，连接词，连词；同时发生
guild			[n]协会，行会
flog			[v]鞭打，迫使
plough			[v]犁，耕；开路，耕田
parsley			[n]<<botany>>荷兰芹，欧芹
myrtle			[n]<<botany>>桃金娘
celandine		[n]<<botany>>白屈菜
knout			[n]皮鞭；[v]鞭打
codex			[n]法典，古抄本
spat			[n]口角；[v]争吵，掌击
tit				[n]乳头，山雀，小马，轻打
tat				[n]劣质的衣物，还击
tit for tat		以牙还牙
provision		[n]食物及必需品；（复数）食物储备
proviso			[n]（合同中）叙述一个条件的一个条款或子句
cloister		[n]修道院；与尘世隔绝
brawl			[n]喧闹，斗殴，闹事；[v]打斗，大声争吵
sideburns		[n]鬓角
suffice			[v]足够，合格
bergère			[n]法式高背扶手椅
infest			[v]骚扰，寄生，大量出没
overrun			[v]彻底击败并取代；大量出没于；超出（账单）；通过改变字母或单词让一个句子变成另外一个；冲破；[n]顾客的超额订单
stud			[n]种马；硬汉；放荡不羁的男人；年轻男人；[n]从地板到天花板的距离；大头钉，螺栓；[v]装饰；每隔一个距离地点缀
upright			[a]垂直的；直立的；正直的；[n][adv]
neutrality		[n]中立，中性
fleece			[n]羊毛；[v]剥削
pelage			[n]哺乳动物的毛
reminisce		[v]回忆，追忆
recollect		[v]重新拾起
gopher			[n]<<biology>>囊地鼠
hovel			[n]小屋，茅舍；住在茅舍
dupe			[v]欺骗，愚弄
impressionable	[a]敏感的，易受影响的，有可塑性的
tunic			[n]长袍，束腰外衣
smashing		[a]了不起的，极好的；猛烈的
crushing		[a]毁灭性的
haruspicium		[n]古罗马祭祀的占卜
matron			[n]主妇，保姆，女舍监
machination		[n]阴谋，诡计
midwife			[n]助产士，促成因素；促成，催生
citrus			[n]<<botany>>柑橘属植物
incognito		[a]隐姓埋名的；[n]虚假身份
substrate		[n]基质，底片，基底
retinue			[n]随行人员
bode			[n]预示，兆头
lycanthrope		[n]狼人
eyeliner		[n]眼线膏，眼线笔
ingest			[v]摄取，咽下，吸收
thereabouts		[a][adv]大约，附近
grudge			[n]怨恨，嫉妒；[v]不愿意，不允许，（嫉妒）某人做成某事
secretiveness	[n]隐匿，分泌
rake			[n]耙子，（舞台）倾斜度，浪子，客车车厢，放荡不羁者；[v]用耙子耙，（树枝、指甲）刮，搜寻，向船尾倾斜，洗劫，大量获取，齐射
enfilade		[n]一排互相连接的房间，通常一个指向下一个；纵向射击[v]纵向射击
dissolute		[a]放荡的
libertine		[n]浪子，性行为放纵的人，自由思想家，放荡不羁者
gangrene		[n]<<medical>>坏疽
steadfast		[a]坚定的，不变的
down-the-line	[a]坚定不移的
true-blue		[a]对一个党派绝对忠诚的；（爱情）忠贞不渝的
staunch			[a]忠实的；安全的；结实的；[v]检查或停止流动；使不漏水		
recreant		[a]痛苦求情的；不忠诚的；[n]懦夫；逃兵
unwittingly		[adv]不知不觉地
salmon			[n]<<dietetics>>鲑鱼；<<colour>>橙色
expectant		[a]期待的，怀孕的，预期中的
progeny			[n]子孙，后裔
posterity		[n]所有后裔
progenitor		[n]直系祖先；祖先
originator		[n]祖先
precursor		[n]前导；祖先；（新陈代谢）前体
predecessor		[n]祖先
forefather		[n]祖先；早期有共同遗产的先人
primogenitor	[n]祖先
delirium		[n]精神错乱，说谵语状态
furore			[n]狂热；公开场合兴奋或愤怒的爆发
furor			[n]狂暴；狂热；公开场合兴奋或愤怒的爆发
beleaguer		[v]包围，围攻，使处于困境，困扰
beleaguered		[a]备受困扰的
pore			[n]毛孔；[v]仔细打量，审视，深思熟虑
waft			[n]挥舞动作；一阵，结状信号旗；[v]（气味）飘出；使飘扬，吹拂
inebriate		[v]灌醉；[a]喝醉的；[n]醉汉
leech			[n]水蛭；[v]像水蛭一样黏上；用水蛭放血；吸走（钱，力量）；[n]方帆的垂直边缘
stumble			[v]蹒跚；失足；犯错；绊倒；偶然或者不期而遇（真相）；粗心地走；[n]
reek			[n]臭味；烟；蒸汽；[v]散发臭味，散发浓烟
gent			[n]绅士，男子
trample			[v]践踏，藐视，伤害
cavalcade		[n]行列，骑兵队；一系列
pap				[n]半流质食物；奶头；软食；政治赞助
copse			[n]杂树林，小灌木丛
birch			[n]桦树；[v]抽打
aplenty			[a]（用于名词后）丰富的；[adv]大量，充裕
conscription	[n]征兵
conscript		[v]征兵
hone			[n]磨刀石；[v]训练（技艺）；渴望；发牢骚；使锋利
smithy			[n]铁匠铺，锻冶场
snifter			[n]狭口的酒杯；一口，一杯
marrow			[n]骨髓，精华，活力，核心
to the marrow	彻骨
rapeseed		[n]油菜籽
commiserate		[v]同情，怜悯
pheasant		[n]野鸡
latch			[n]门闩；[v]闩上；（on，onto）纠缠；（on，onto）亲密地并且附和地依赖
flay			[v]剥皮；（风）吹打；严厉批评
bedchamber		[n]卧室，寝室
chamberlain		[n]管家，宫廷大臣
puncture		[n]小孔；[v]刺穿；使泄气；爆胎
tussle			[v]扭打；争夺
lush			[a]猛长的（植物）；物产丰富的；好吃的；（建筑）富硕的；悦耳的[n]喝酒；酒鬼；[a]丰富的，豪华的
marinate		[v]腌制，浸泡（食物）在卤汁中
batty			[a]发疯的，古怪的；[n]（人）臀部
preventative	[a]预防法
feudal			[a]封建制度的，领地的；世仇的；与中世纪费用有关的
supple			[a]灵活的，柔软的，顺从的，易弯曲的；[v]使柔软，使顺从
manliness		[n]男子气概，勇敢
racket			[n]球拍；喧闹；社交活跃；欺骗性的模式、公司或活动；不合法的威胁或贿赂；简单高效的生活方式；[v]社交活跃；过花天酒地的生活
scurvy			[n]坏血病；[a]卑鄙的，下流的
pendant			[n]垂饰；吊灯；[a]下垂的
hunk			[n]大块，强壮；[a]好的，行的
rhyme			[n]韵律，韵脚，押韵
wart			[n]树瘤；缺点；疣
barmy			[a]傻乎乎的，痴呆的；愚蠢的；古怪的
bum				[n]流浪汉，屁股，狂欢作乐，能力差的人；[v]流浪，乞讨；[a]无价值的，劣质的，不愉快的
snail			[n]蜗牛，迟钝的人
anthill			[n]人群密集的地方，蚁冢
spruce			[n]云杉；[v]打扮整齐
burrow			[n]（动物，兔子）地洞；[v]钻入，挖地洞
meadow			[n]草场，牧场
slither			[v]滑行，爬行，踉跄地走；长薄片，碎片
gravel			[n]碎石；碎石覆盖的表面；结石；[v]用碎石铺；使困惑；烦扰
gravelly		[a]（人）声音刺耳的；用碎石铺满的
grating			[a]木制或金属的格，用于形成一个封闭空间；栅栏；光栅；[a]恼人的
throaty			[a]嗓子深处的；声音粗糙的
gruff			[a]潦草的；粗糙的；[v]发出粗糙的声音
husky			[a]情绪狂躁的；大；[n]很大的东西
rasping			[a]刺耳的
floor			[v]推倒；使吃惊；快速加速
stratum			[n]人造的一层；河床的一层岩石；一层生物组织；历史学或社会学的代表一个时期或发展状态的一部分；有序组织的一层或一个等级
bestrew			[v]到处都是
pepper			[v]用导弹清洗；反复快速打击；像辣椒一样撒或覆盖
subpopulation	[n]<<computer science>>可以识别的一部分或子集
gradation		[n]一系列连续的状态；（发展）一步；色彩或阴影的一阶
ablaut			[n]（诗歌）元音交替
tint			[n]色彩；对品质的一个小修改；通过密平行线组合产生的雕刻效果；用作背景的浅颜色；[v]染发，染色
gentry			[n]社会上层或统治阶层；有钱的地主；一类的人；绅士的阶层
flabbergast		[v]使大吃一惊
surreptitious	[a]秘密的，鬼鬼祟祟的
downright		[a]平淡的；彻头彻尾的，直率的；[adv]彻底，完全，径直向前
short-spoken	[a]由于少言而粗鲁的
curt			[a]简洁的；由于少言而粗鲁的；<<mathematics>>维度低的
mealymouthed	[a]不直接的，有城府的
unceremonious	[a]不正式的；唐突的，粗鲁的，突然的
unpleasantry	[n]日常不愉快的事；诋毁
tapestry		[n]织锦，挂毯，绣帷
beseech			[v]恳求，哀求，乞求，急切地要求得到
implore			[v]恳求
importune		[v]恳求；反复请求；[a]恼人的
importunate		[a]恼人又紧急的；恼人的
impetrate		[v]恳求
entreat			[v]恳求（劝服或客服某种困难）
entreatingly	[adv]请求地
conjure			[v]恳求；变戏法；召唤
conjure with	认为...很重要
adjure			[n]恳求；告诫
besiege			[v]恳求；使担心；包围
unthinking		[a]无思考能力的，不留心的，无头脑的
unmindful		[a]不思考的
hoi polloi		[n]<<Greek>>民众
puddle			[n]水坑，泥潭；[v]搅拌泥浆
tallow			[n]动物油脂
appease			[v]使平息，使满足
depart			[v]离开，触发；启程；违反；去世；[a]逝世的
wiggle			[v]扭动
eel				[n]<<dietetics>>鳗鱼，鳝鱼
wriggle			[n]蠕动，蜿蜒
noggin			[n]脑袋；小杯；少量
unspeakable		[a]无法形容的；非常坏的
haunch			[n]臀部，腰部
enticement		[n]诱惑
tripe			[n]牛肚；废话；不值钱或攻击性的东西
precognition	[n]预知
hail			[n]冰雹；[v]致敬；招呼
lout			[n]笨拙的人；[v]藐视；屈服
shatter			[v]粉碎，打碎；破坏；[n]
speck			[n]灰尘，污点，一点点；[v]使有斑点
speckle			[n][v]斑点
dapple			[n]圆形斑点或颜色块或区别于背景的阴影颜色；有斑点的动物；[v]
shag			[n]不均匀的头型；切好的烟草；鸬鹚等海鸟；[a]破破烂烂的；[v]使蓬乱，空中接球；[n]长绒地毯；[v]性交；[v]追赶（球）；追赶；跳舞
gigolo			[n]舞男，小白脸
rancid			[a]腐臭的，令人作呕的
wince			[v]退缩，脸部肌肉抽搐
shallot			[n]<<dietetics>>葱
cinnamon		[n]<<dietetics>>肉桂树，肉桂色
connoisseur		[n]<<French>>鉴赏家，内行
broach			[n]胸针；有尖的工具；[v]首次打开；进入（矿洞、故事）；提出，钻孔，开始讨论；从下面破冰；[v]（broach to）<<nautical>>紧急转向
gander			[n]雄鹅，呆子；闲逛
epithet			[n]绰号
appellation		[n]称呼，名称
bulwark			[n]堡垒，防护堤；[v]保卫
onslaught		[n]猛攻，突击
squander		[v]挥霍，浪费；使消散；[n]
reanimate		[v]鼓舞，使复活，使恢复生气
scruple			[n]微量；顾虑，踌躇
reactionary		[a]反动的，保守的
fetter			[n][v]束缚
unfettered		[a]无拘无束的
ere				[prep][conj]<<literal>>在......之前，宁愿
subside			[v]平息，下降，减弱
harry			[v]烦扰，不断袭击；通过不断骚扰使之移动
reprieve		[v]推迟（定罪）；短时间缓解问题
crevice			[n]裂缝
sprinkle		[v]撒，洒，零星分布；点缀；[n]少量；小雨；（撒在糕点上装饰用的）彩糖
whine			[v]发牢骚
stank			[n]池塘，水沟；<<British>>小水库
parlor			[n]客厅，会客室
feces			[n]<pl.>排泄物，粪便
rummage			[v][n]洗劫；仔细检查，翻找；[n]混乱的杂物集；用来卖的杂货；在一堆乱七八糟的东西里的仔细查找
trustworthy		[a]可靠的，可信赖的
superintendent	[n]监督人，负责人
grievance		[n]不满，委屈，抱怨
hoe				[n]锄头
bauble			[n]小玩意，美观而无价值的东西
itinerant		[a]巡回的；[n]巡回者
magnanimous		[a]宽宏大量的
lofty			[a]品德高尚的；高等级的；骄傲自大的；非常高的；偏离常规的；有浓郁、坚韧、有弹性的纺织纤维的
altitudinous	[a]高的
haughty			[a]大胆轻蔑地骄傲的，藐视低级事物的
stiff-necked	[a]骄傲的，顽固的；呆板的，不能变通的
self-assertive	[a]自信的
go-getting		[a]自信的
high-pressure	[a]自信的
in-your-face	[a]自信的
outskirts		[n]郊区
peat			[n]泥炭；裸体的活体女性
miller			[n]磨坊主
huntsman		[n]猎人，管猎犬的人
undersign		[v]在末尾签名
trickle			[n]滴，细流;使细流；慢慢消散
distill			[v]成滴流下；蒸馏；使集中
hooligan		[n]小流氓
apprenticeship	[n]学徒身份，学徒期
portray			[v]描绘，扮演
engraving		[n]雕刻
pictogram		[n]象形文字
basin			[n]盆地，流域
snuggle			[v]偎依，紧抱
indelible		[a]难忘的，擦不掉的
memorable		[a]忘不掉的
imprint			[n]印记，痕迹；[v]刻记号
raucous			[a]沙哑的，刺耳的，粗糙的
hell-raising	[n][a]掀起波浪
knockabout		[a]suitable for rough use；喧闹的
robustious		[a]粗犷的；喧闹的
roisterous		[a]喧闹的
rollicking		[a]粗犷而无忧无虑的
councilor		[n]顾问，评议员
pilgrimage		[v][n]朝圣，漫游
renovate		[v]更新，修复
troubadour		[n]<<French>>行吟诗人
renown			[n]声誉，名望
shirk			[n]溜走；逃避，推卸
get around		[v]逃避；（to）找到或花费必要的时间或精力；从一个地方到另一个地方；被公开或成为主流
tyke			[n]劣犬，野狗，小孩子
shrubbery		[n]灌木丛
hooch			[n]烈酒
forthwith		[adv]立即，毫不犹豫
bigwig			[n]权贵之人
sleepyhead		[n]瞌睡虫
séance			[n]降神会，会议
doorframe		[n]门框
hue				[n]色彩，色度，色调
strum			[v]漫不经心地弹拨；[n]一下弹奏
defraud			[v]欺骗，通过欺骗获取
preen			[v]打扮，赞扬；洋洋自得；整理羽毛
primp			[v]精心仔细地打扮；试镜
latrine			[n]公共厕所
convenience		[n]厕所；合适的时间；[a]为便于使用设计的
lavatory		[n]厕所；洗手间
potty			[a]不重要的；[n]（小孩用的）厕所；厕所
heresy			[n]异端，异教
conformity		[n]顺服
firmament		[n]天空，苍天，某个领域或活动区域
exempli gratia	例如
whatsoever		无论什么
utmost			极度，最大可能
severity		[n]严重程度
mead			[n]蜂蜜酒；草地
bald			[a]秃顶的；[v]变秃
perpetrator		[n]犯罪者，行凶者
perpetual		[a]四季开花的，永久的
ceaseless		[a]不停止的
inquire			[v]询问，查究
holler			[v]发牢骚，大喊
preacher		[n]传道士
preach			[v]说教，讲道
slink			[v]潜逃，逃走；偷走；（饲养的动物）提前产子；[n]提前于孕期的产子；[a]未成的生子或堕胎的
pussyfoot		[v]谨慎前行；控制自己的投入程度
affix			[v]粘上，署名，加罪责于；[n]词缀
jerkin			[n]无袖外套，坎肩
lovesick		[a]苦恋的
beau			[n]花花公子；男朋友
swain			[n]乡下人；牧羊人；男性爱慕者
countess		[n]伯爵夫人
dockside		[a][adv]码头旁边
skinflint		[n]吝啬鬼
flint			[n]燧石，火石，很硬的东西
en garde		<<French>>警戒，预备，防守
scarecrow		[n]稻草人；吓人但是没有伤害的东西；破烂或非常瘦的人
smatter			[v]略知一二，涉猎;[n]一点点
prattle			[v][n]闲聊，胡说；像小孩一样说
prate			[v]漫长无目的地说
plaudit			[n]大声喝彩
réclame			[n]<<French>>演戏或宣传技巧，公众赞扬
bloke			[n]家伙，小子
squatter		[n]占据财产但没有权力或职位或付租金的人，大牧羊场场主；[v]淌水走过
especial		[a]特殊的
nuisance		[n]<<French>>讨厌的人，麻烦事
hangover		[n]宿醉；残留物
beget			[v]产生，招致，引起，当......的父亲
catalyze		[v]产生；发生分解反应
draw on			产生；招致；（黑夜）到来
effectuate		[v]产生效果
beset			[v]困扰，围攻；镶嵌
harrow			[v]掠夺
finesse			[v]偷牌；巧妙处理，施展巧计；[n]灵巧的策略
ovation			[n]热烈欢迎
gob				[n]凝块，水兵
yokel			[n]乡巴佬
pugilist		[n]拳击手
conceit			[n]自负，狂妄；[v]幻想
coot			[n]傻瓜，笨蛋
trobairitz		[n]女吟游诗人
chorister		[n]唱诗班指挥
barge			[n]驳船，大型货船；[v]蓄意冲撞
cruise			[n]巡航，迅游，乘船游览
extol			[v]赞扬，吹捧
carol			[n]古老的有伴唱的圆形舞，快乐的歌声；[v]欢快地唱
mirth			[n]快乐或被笑声陪伴
jovial			[a]快乐的
jocund			[a]快乐的
resound			[n]回声；赞扬
skyward			[a]向天空的；[adv]朝天
stallion		[n]种马
thereupon		[adv]因此
betwixt			[prep]在......之间
nemesis			[n]（复数~ses）报应；苦痛
lather			[n]肥皂泡；[v]使激动，狠打
foam			[n]泡沫
froth			[n]泡沫
dither			[v]颤抖；[n]兴奋，迷惑
chinny			[n]爱说话的人
granite			[n]花岗岩；冷酷无情
turnaround		[n]彻底改变，转机
sully			[v]玷污，使丢脸
wench			[n]少妇，乡下姑娘；通奸
clobber			[v]击败，痛打；[n]还草胺除草剂
trollop			[n]妓女，堕落的女人
sudsy			[a]肥皂般的，起泡沫的
huff			[n]愤怒
corset			[n]（妇女用的）紧身外套；严格控制
squabble		[v]大声争吵
bate			[v]使软化，减弱，压制；[n]愤怒状态
ruckus			[n]喧闹，骚动
morsel			[n]一口，少量（食物）
wherewithal		[prep]用以；[n]必要的资金
mayfly			[n]蜉蝣
triumvirate		[v]三人领导小组
scoff			[v]嘲笑，狼吞虎咽；[n]笑柄，口粮
daisy			[n]雏菊；极好的，上等的
snuck			
tuck			[n]食物，船尾；卷进，藏起，大口吃，舒适地裹住
fortuneteller	[n]算命者
barney			[n]大声争吵
prance			[v]昂首阔步，（马）后足立地腾跃
whereabouts		[n]下落；[adv]在何方
knack			[n]诀窍，本领
grind			[v]磨碎，折磨；[n]苦活
hallowed		[a]神圣化的
knicker			[n]女式短裤
nowt			[n]恶人，公牛
townhouse		[n]城市连体房屋
payback			[n]偿付，报复
trombone		[n]长号
lute			[n]琵琶
mandolin		[n]琵琶乐器
truss			[n]构架；[v]捆绑
prickly			[a]易怒的，多刺的
irritable		[a]过敏的，急躁的
menopause		[n]更年期，绝经期
unbearable		[a]难以忍受的
topaz			[n]黄玉
whiff			[n]臭味，一点，（高尔夫，棒球）挥空棒；[v]发臭，闻，喷出
sleuth			[n]侦探，警犬；[v]侦查
stiff			[a]呆板的，坚硬的，僵硬的，严厉的，（酒）烈的；[n]死尸，令人讨厌的人；[v]诈骗
spore			[n]孢子
lummox			[n]笨蛋，不中用的人
horrendous		[a]可怕的，惊人的
burp			[v]打嗝
ulcer			[n]溃疡，腐败
goblet			[n]酒杯，高脚杯
warp			[n]弯曲，偏见；曲解
congregate		[v]聚集
quote			[n]引述；报价；作证
lid				[n]盖子，眼睑；盖盖子
fateful			[a]重大的，决定性的
archmagnificency		
chapel			[n]小教堂，礼拜
barracks		[n]兵营
gristly			[a]<<biology>>软骨的
blackguard		[n]恶棍；[a]粗鄙的
wherein			[adv][prep]在其中
juggle			[v]玩戏法，欺骗
thataway		[adv]按指示，朝那个方向
wagon			[n]马车
pointy			[a]尖的
trot			[v]慢跑；[n]小步
movable			
oaf				[n]呆子，白痴，畸形儿
sloven			[n]懒散的人，不修边幅的人
feud			[n]争执
clad			[a]穿衣的；[n]金属保护层
cutthroat		[a]残酷的；[n]凶手
desecration		[n]亵渎
serenade		[n]小夜曲
mainspring		[n]丰富动力，主发条
developmental	[a]发展的，启发的
ginger			[n]姜；[v]用姜调味；使有活力
squeal			[n]尖叫；（向警方）告密
squirm			[n]蠕动；不舒服
mores			[n]习俗，道德理念
townsfolk		[n]市民，镇民
spectacle		[n]场景；演出
lining			[n]内层
flock			[n]群；棉束
tryst			[n]幽会
minstrel		[n]歌手，艺人，吟游诗人
eunuch			[n]太监
soak			[v]吸入，浸泡
heinous			[a]可憎的，十恶不赦的
denizen			[v]给居住权；[n]常客；外来语
lousy			[a]讨厌的，污秽的
panache			[n]<<French>>羽饰；耍派头
lode			[n]矿脉
sturdy			[a]坚定的，强健的
lullaby			[n]摇篮曲
pinewood		[n]松木，松林
pine			[n]松树，凤梨，菠萝；[v]渴望，哀悼
boatwright		[n]造船工人
snot			[v]流鼻涕
snotter			[n]鼻涕
whimper			[n]呜咽，啜泣；呜咽声，啜泣声
cadaverine		[n]尸胺，1，5-戊二胺
overripe		过熟的
zounds			[interj]咒骂声
flail			乱动，猛击；连枷
wrapping		包装纸
granary			谷仓
golem			有生命的泥人，魔像
porcelain		瓷器；瓷制的，精美的
ironclad		穿铁甲的，坚固的；铁甲舰
cling			坚持，附着，紧贴
brine			卤水，盐水；用浓盐水处理
pickle			泡菜；腌制
untouched		未受影响的
unmatched		无与伦比的，无可匹敌的
crumb			面包屑；弄碎，捏碎
sensory			感觉的，知觉的
fondue			[n]<<French>><<dietetics>>溶化奶油，干酪，芝士火锅
grana padano	[n]<<dietetics>>波河干奶酪
kestrel			茶隼，小鹰
marble			大理石；冷酷无情的
plafond			天花板画，装饰的天花板
sludge			泥泞，沉淀物，浮冰
ford			浅滩；涉水而过
furuncle		疖
resultant		合力，结果；由此导致的
wheeze			喘息；喘息声
poker			拔火棍；烙
beforehand		预先，提前
ironically		讽刺地
lark			云雀，百灵鸟；愚弄，嬉耍
monty			必定的事物（尤其指赛马时必赢的马）
afeard			恐惧的
portrayal		描绘，肖像
afore			在......之前
undergrowth		林下植物
white elephant	没价值的东西，需要大量精力却没什么产出的东西，对所有者没有意义但对他人有用的东西
gambit			玩家通过几步冒险而获得优势的棋类开局，用于导出话题的标志，说话的主题，精心计算的行动
bruit			散播谣言
teleological	目的论
chilblain		由于冻伤而形成的发炎性肿胀或溃疡
sobriquet		[n]描述性的名字或绰号，昵称
respite			暂时的休息
lackadaisical	死气沉沉的
undulate		随波浮动，在音量/音调或韵律上升降，有一个波浪形的外表
pedagogical		说教的
aerie			悬崖或山顶的鸟巢，高且隐蔽的住所或位置
coruscate		一闪一闪，在技术或风格上出色或炫耀
Noachian		与Noah有关的，古老的
spoonerism		首音互换（tons of soil for sons of toil）
toil			苦工，艰苦地行走
fiduciary		关于信任的；信托基金
knackered		筋疲力尽的
deke			欺骗以使对手失去优势，（冰球）佯攻
decoy			诱饵，诱骗
hobbyhorse		木马，跳舞用的木马
maunder			缓慢且毫无目的地走，不直接地说
grumble			不满意地说，大声且低沉地说
growl			咆哮
rumble			低沉地说
welkin			天空的穹顶，天堂，高层的大气
hornbill		犀鸟
boudoir			闺房，古代贵族妇女的会客室
décor			装饰，布景，家居风格
vial			小瓶，药水瓶
lolly			棒棒糖
lollygag		浪费时间
carcass			尸体，残骸
predicament		困境，窘况
foment			煽动，挑起，热敷
mésalliance		非门当户对的婚姻
instill			灌输，缓慢滴入
smolder			闷烧
knead			揉面，按摩
inordinately	
chamomile		[n]<<botany>>甘菊
cheeky			厚颜无耻的
smooch			接吻，弄脏；污迹
cabaret			歌舞厅
chameleon		变色龙
courtesy		礼貌，礼节
demented		发狂的
nip				捏，夹，掐断
herpetology		[n]<<biology>>爬虫学
syphilis		[n]<<medical>>梅毒
excruciating	折磨人的
undeterred		未受阻的，未被吓住的
slumber			睡眠，麻木不仁
carefree		无忧无虑的
lenient			宽大的，仁慈的
fainéant		无所事事的
swath			细长的列
venture			敢于；有风险的企业
hawk			鹰；叫卖，清嗓子，严密监视
sparrowhawk		雀鹰
neckhole		领圈
taxidermy		（动物标本）剥制术
wile			欺骗，消遣；诡计，阴谋
forewarn		预先警告
ulterior		将来的，隐秘不明的
break bread		共餐
adjunct			附属物，修饰语，助手
wily			狡猾的，诡计多端的
mound			堆，高地，坟堆；堆积
bestow			授予
diviner			预言者
partake			吃，分享，分担
audacious		无畏的，鲁莽的
ferocious		残忍的，惊人的，狰狞的
talon			爪子
drake			公鸭，蜉蝣
prowl			徘徊，潜行，搜寻
menad			女祭司，暴怒的女人
rear			后面，后方部队，屁股；后面的；养育，抚养，栽种，用后腿直立
velvet			天鹅绒
velvety			天鹅绒一般柔软的
slime			粘液，烂泥
forethought		预谋；预先计划好的
eerie			可怕的，怪异的
craving			渴望 
loiter			虚度，闲荡
heretofore		迄今为止
seaweed			海藻，海草，海带
ornery			坏脾气的，低劣的
da capo			从头重复乐曲
dacquoise		蛋白酥皮奶油卷
lacrimal		泪的，泪腺的
daffy			愚笨的，疯狂的
Dadaism			崇尚虚无派
daffodil		水仙花
daguerreotype	银版照相
dagwood			多层三明治
dainty			美味的，讲究的
dais			讲台
hilt			刀把，柄
to the hilt		最大限度，完全
incentivize		用物质奖励刺激
plaster			石膏，膏药；减轻，粘贴
railroad		铁路；用错误的指控或不充足的证据以不正当的速度定罪，不假思索地挤过去
mot juste		最恰当的用词或短语
lynch			私刑；处以私刑
clunk			沉闷的金属声；用力敲打，发出咚咚的声音
clunky			沉重的，笨拙的 
requiem			安魂曲
dirge			挽歌
threnody		挽歌
dandle			在胳膊或膝盖上上下移动来表达亲密，宠爱
cocker			溺爱
mollycoddle		溺爱
pamper			溺爱，逗乐
glut			供过于求；供应过多，吃得过饱
wet-nurse		乳母；当乳母，关爱
udder			乳房
dandify			打扮时髦
dapper			短小精悍的
darkroom		（摄影）暗室
darken someone's door		出现在一个某人已不再被欢迎的地方
cyclosporine	环孢霉素
personage		要人，名人
uncanny			神秘的，可怕的，离奇的
voluminous		大量的，大的，盘曲折叠的
hulking			笨重的，质量大的
bantam			身材矮小且常处于战斗性格的人；小的，傲慢好战的
pert			无礼的，鲁莽的，时髦的，活泼鼓舞的，有生气的
jaunty			活泼的，有生气的 
beret			带有头饰和软平顶的没有帽舌的羊毛帽子
combative		好战的
stature			身材，高度
dinky			极小的，整洁的，微不足道的
smallish		
puny			弱小的，微不足道的
pygmy			侏儒；矮小的
shrimpy			矮小的
largish			
whopping		巨大的；非常
whop			打，抽出，征服；重击，击打声
whack			用有回声的打击打，打败；有回声的一击，部分，分成，状态，做某事的机会或尝试
out of whack	不在正常的秩序或形态，不合拍
whacking		巨大的，惊人的；非常，绝对
facultative		授权的，可选的，在特定场合下发生的
embalm			保护死尸以防腐烂，喷香水
dastard			懦夫；可鄙的
daunt			使气馁
date rape		约会强暴
daybreak		黎明，破晓
day-neutral		无论有无阳光均能生长的
dazzle			耀眼的光芒；使目眩
daystar			晨星
deadbeat		游手好闲者；非周期的
deadpan			面无表情的，不动神色的，故作严肃的
deadweight		自重，总重量
dealation		脱翅昆虫
death camp		死亡集中营
death squad		杀人小队，敢死队
death trap		危险建筑
debacle			大灾难，完全的失败，猛烈的解冻，暴动
rout			暴动，灾难级的失败；彻底击败，使完全混乱，驱散（烦恼）
shard			鞘翅
slippery		光滑的，狡猾的，不稳定的，模棱两可的
furtive			秘而不宣的，鬼鬼祟祟的 
thump			大声攻击，给予强有力的支持
linden			菩提树
vise			老虎钳
usurp			篡夺，侵占
usurpation		
arrogate		不公平地霸占或掠取，不合理地宣称拥有，代表别人宣称拥有
preempt			霸占，用更有价值的东西取代，防止某事发生
forestall		预防，提前准备好，用预先准备的方法阻止
obviate			预先准备以使一个行动变得没有必要
stave off		预防 
fend off		自我防御
perchance		偶然，可能
usher			引导员，迎宾员；迎宾
camaraderie		友爱
sportsmanship	运动员精神
claimant		权力或荣誉的候选人
cesspit			污水坑，粪坑
stroll			散步，闲逛
oilcloth		油布
toothsome		美味的，令人愉快的
heartrending	悲惨的，令人心碎的
drear			阴郁的，沉闷的
mournful		悲伤的，抑郁的
dismal			阴暗的，抑郁的，非常糟糕的
hangar			飞机库
plume			羽毛
shack			小棚
hutch			用于存储的箱子，有开放式抽屉的橱柜，小屋，关动物的笼子
coop			笼子；拘禁，关进笼子
shanty			水手工作时唱的歌，用木头粗糙制造的小屋
berth			卧铺，舱位，差事；停泊，提供床铺
incorrigible	不可救药的，积习难改的
dishrag			抹布
obscenity		猥亵，淫秽
ponce			男妓
sermon			布道
debauch			使堕落，放荡
pervert			使腐败，误导，滥用，扭曲表意或感觉
subvert			从基础毁坏，使道德败坏 
vitiate			损坏，使道德败坏，使无效
uplift			抬高，让地面的一部分升高到高于周围区域，提升精神/社会或智力状态
leper			麻疯病患者，受蔑视的人，被孤立者
catafalque		灵车，灵柩台
sterilize		消毒，使不育
modus operandi	办案手段
outlaw			歹徒；禁止，取缔，宣布...为不合法
reliquary		圣物箱
paraphernalia	[n]随身用具；已婚女性根据习惯法可以自由支配的个人物品
common law		[n]习惯法
tackle			[n]用于某一个具体事情的一套装备；船的传动装置；一套机械上用的绳子和滑轮，用于提或拉；[v]抓住，以使停止或屈服；解决（问题）；用绳子固定或使安全；<<football>>抢球
assemblage		[n]人或物的集合；由垃圾、或边角废料组成的一套有艺术感的东西
unannounced		突然的，未经宣布的
songster		歌手，诗人
nab				捉住，逮捕，掠夺
flunky			仆人，走狗
liveried		穿制服的，穿规定服装的
lackey			谄媚者，仆人；谄媚 
menial			仆人的，低贱的，没有尊严或意思的；做低贱工作的人
retainer		仆人，雇工
abject			沉入或存在于一个低状态，非常差或严重，精神低迷的，毫无希望的，低贱屈服的
ingratiate		迎合
phylactery		护符
blot			污渍，墨渍，瑕疵，道德上的污点，耻辱，美中不足；撒上毁坏颜色的物质，用臭名玷污，用吸附性物质干燥
inconspicuous	不易察觉的
chestnut		栗子，陈腐
stale			陈腐的，说过很多遍的
bromide			溴化物，陈词滥调，平凡乏味的人
hackney			用于平常骑的马，用于雇佣的马车或机车；用于公共雇佣使用的；经常使用，使老套/庸俗/平常
moth-eaten		弃用的，过时的
shopworn		由于长时间存放而消逝/破坏/毁坏的，由于过度使用或熟悉而陈腐的，穿坏的
stereotyped		铅版印刷的，老套的
threadbare		老旧的，非常穷的，由于成本低或破旧而不符合标准的，新鲜度用尽的
timeworn		穿破或破损的，古老的，陈腐的
ragamuffin		衣衫褴褛的人，很穷且脏的小孩
tatterdemalion	衣衫褴褛的，弃用的，处于衰退状态的
tacky			华丽而炫耀的，缺乏营养的，破旧的，表皮有点粘的
seedy			质量或状态差的，破旧的，状态不佳的，有点声名狼藉的
groaner			陈腐的笑话/观察或故事
groan			表达沉重的悲哀，发出不悦耳的声音
corny			令人作呕地老旧过时的，与玉米有关的
mawkish			令人作呕的 
trope			修辞表达，陈词滥调
truism			无可置疑或自解释的事实，通过明显以至于不用强调的事实
shibboleth		广泛流传的信仰，太过显然的事实，特别团体的标志性用语，标志性习惯或用法
homily			短小的布道，有关道德的演讲或谈话，鼓舞人心的标语
platitude		庸俗，陈词滥调
ersatz			代用的，假的，人造的；代用品，仿制品
spur-of-the-moment		立刻，不假思索
gouge			用园槽钩，欺骗
hive			蜂群；存入蜂箱，群居
freethinker		思想家
scribble		潦草的字；乱涂，潦草或匆忙地写，粗梳羊毛
scrawl			乱写，乱涂 
squiggle		胡乱的字，花体；乱写
demijohn		酸菜坛
frill			褶皱
frilly			多饰边的
groat			昔日英国的四便士硬币，少量钱
pauper			乞丐，穷人；贫民的
sequin			用作衣服饰物的小亮片
cord			绳索
cordon			装饰的绳子或带，警戒线；用警戒线隔离
clash			冲突，不协调；碰撞声
partway			一定程度上
extraordinaire	非凡的，异常的
phenomenal		通过感官而非思考或直觉知道的，现象而非理论上的，不平凡的，突出的
preternatural	超乎自然的，不平凡的，不能用常规方式解释的，
frivolous		无聊的，轻佻的，琐碎的
pantheon		万神庙
pup				小狗，幼畜
veal			小牛，小牛肉
flounder		不知所措，笨重或不好地进行或行动；比目鱼
flatfish		比目鱼
scorpion		蝎子，天蝎座
ternary			三元的
dinghy			小艇
hinge			铰链，关键，转折点；用铰链连接
candelabrum		烛台
trout			鲑鱼 
tout le monde	全世界
cobbler			补鞋匠
skullduggery	欺骗
subsidiary		辅助的，次要的
thereof			由此，在其中
therefrom		来自或在其中
recourse		求援，追索权，可用的援助力量
resort			资源，帮助，习惯或经常性的拜访，王座，经常拜访的地方，用于向游客提供休闲和娱乐的地方；经常拜访，有资源
purlieu			经常拜访的地方，周围环境，限制
stomping ground	喜欢或习惯性拜访的地方，熟悉的地方
stamping ground	喜欢或习惯性拜访的地方，熟悉的地方
baccalaureate	学士学位
spurn			唾弃，冷漠，踢开
deselect		解散，反感，把选好的东西从软件接口中移除
disapprove		不喜欢，拒绝赞成，拒绝
nix				投反对票，拒绝
pass up			让......过去而不接受或利用，反对，下降 
reprobate		流氓，恶棍；道德败坏的，受诅咒的；强烈谴责，拒绝
throw out		突然或不被期待地从某地移除，表达情感，拒绝，展示
throw over		不顾连接或职责地背弃，拒绝
bloodshed		流血，杀戮
altogether		完全，总计
basically		在低程度上，在性情上，大部分，简单地（生活）
by and large	总体上
skimp			给不充足的或勉强足够的精力或努力或资金，通过这种手段节约；不够的
skimpy			由于没有足够的努力或资金而在供给或执行上短缺
scanty			缺乏的
exiguous		极度缺乏的，不充足的
wrest			用暴力的扭曲的步伐拉/强迫/移动，通过暴力劳动而费力地获取
wrench			拧，强迫遭受精神折磨；宁的动作，扳手
pry				撬开，刺探
hand-to-mouth	没有或不提供除了基础需求以外任何东西
meager			瘦的，缺乏质量的（富裕，力量），数量或质量上不足的
niggard			吝啬鬼
cheapskate		可怜或小气的人，避免支付自己的一小部分花销的人
churl			无礼的人，孤独怪癖的人，下巴老
ceorl			社会下层的自由人
morose			孤僻的，郁闷的
hunks			脾气坏天性差的人
surly			表现上令人害怕的（天气），令人恼怒地没有礼貌的
crabbed			暴躁的，潦草的，晦涩的 
imperious		装横的，迫切的
sullen			恼怒的，脾气差的
churlish		没有礼貌的，脾气暴躁的
miser			自私贪财的人
penny-pinching	节俭，过度节俭
piker			胆小鬼，谨慎的赌徒
scrooge			守财奴 
tightwad		吝啬的人
niggardly		在花费或授权上令人嫉妒地自私的，提供非常有限的补给的
stingy			不大方的，在使用或花费上节约或不足的
chintzy			廉价的，印花棉布制成的
closefisted		小气的，吝啬的
parsimonious	节约的，有限制的
parsimony		在钱或资源上节约的品质或状态
stint			在某个特别活动上花费的一段时间，一段定量的工作，限制；节俭，to restrict with respect to a share or allowance
stinting		节约的 
tightfisted		不愿意花钱的
part with		放弃拥有或控制权
uncharitable	不慈悲的，严厉无情的
bounteous		慷慨的，丰富的
bountiful		在给予礼物或帮助上慷慨无束的，产量丰富的
freehanded		慷慨的 
munificent		慷慨的，以慷慨为标志的
municipal		市政的
remunerate		支付报酬，赔偿
openhanded		慷慨的 
economize		节俭
liberal			慷慨大方的，充足的，丰富的，松散的，不受权威/严格标准或传统形式束缚的
plenteous		高产的，大量存在的
scrimp			吝啬地提供，使变小/变少或不足
frugal			在使用资源上表现的节约的
prodigal		浪费的，不理智地浪费的，奢侈的
luxuriant		富饶的，奢侈的，多产的
profligate		非常充足的，完全堕落的，不羞耻地不道德的，享乐的
dissipation		驱散，消散，浪费的使用，不节制的生活，过量饮酒，自我放纵，享乐
licentious		缺乏法律或道德束缚的，不尊重性束缚的，不理会严格的正确规则的
spendthrift		不具远见或浪费地花费的人
squandering		浪费的
thriftless		没有价值或使用价值的，在花费上不具远见的
thrift			在钱上的谨慎管理，健康茁壮的成长
hierophant		导师，圣者
toddler			学步的小孩
toddle			东倒西歪，蹒跚学步
totter			不稳定地走，震动并且快要摔倒，变得不稳定；不稳定的步伐
careen			把船放到海滩上从而清洗或修补船体，在两侧之间来回摇摆，全速前进
teeter			不稳定地走，摇摆
waddle			小步从一侧向另一侧走，笨拙地慢走；笨拙且摇晃的步伐
lurch			一次突然的颠簸/摇摆/倾斜的移动，踉跄，以二倍以上于对手得分的压倒性优势获胜（cribbage）；踉跄移动，鬼鬼祟祟地在一个地方闲逛
in the lurch	处于易受攻击且没有支持的位置
dodder			由于虚弱或年龄而震颤，虚弱不稳定地执行或前进
wobble			踉跄地走；声音音量的的断断续续的变化
waver			[v]在许多选择之间摇摆不定，在观点/信念/方向上摇摆不定，前后摇摆，震动，犹豫好像要放弃一样，发出不稳定的声音；[n]这样的行为，这样做的人
falter			不稳定地走，放弃，犹豫地移动，虚弱地说话，失去动力或效益
stammer			[v]说话时做出不自主的停顿；[n]这样的人
saunter			闲逛，漫游
peraumbulate	徒步旅行经过，用步行的方式做一次官方视察（对边界），漫游
rove			漫步（有力量的，有时有明确目的），把纺织纤维用松结编织在一起
ramble			漫步（不关心自己的目的），没有明确目的且冗长地说或写，不规则地伸展或生长；娱乐性的远足，没有明确目的的行走，冗长且没有目的的故事或讨论
traipse			[v,n]漫步（不稳定但是有时可能有明确目的）
mooch			[v]缓慢或无目的地移动，从别人身上拿东西或活在他人的慷慨之上且不提供任何回报；[n]这样的人
long-winded		冗长的
excursion		远足
caulk			[v,n]填补船的漏洞
hull			船体，外壳；去壳
seesaw			跷跷板，秋千
honk			雁叫声，汽车喇叭声
tad				少量，小孩子
grotto			洞穴
fume			烟，刺鼻性有毒气体，怒气；散发气体，生气
in a fume		生气
on fumes		残余很少的能量或力气
alembics		蒸馏器
gadfly			牛虻，讨厌的人 
pimpernel		紫蘩蒌
practicum		有监督的实习
rudder			船舵，飞机舵
cowardice		怯懦
poltroon		胆小鬼
pusillanimous	胆小的，优柔寡断的
spineless		无脊椎的，没有骨气的
intrepid		勇敢的，无畏的
ancestral		祖先的，祖传的
equinox			昼夜平分点
starry			布满星星的，与星星有关的
backwater		死水，隔绝的地方或处境，（研究或商业）不受欢迎或不重要的地带
inquietude		不安的状态
pristine		[a]原始的，最早期时代的，未经使用/污染/侵蚀的（被文明）（森林），全新的
edifice			[n]建筑，大的抽象建筑
shawl			[n]披巾
floorboard		[n]地上的板子，机车的地板
keelhaul		[vt]拖在船的龙骨上作为惩罚或虐待，强烈地指责
baste			[v]
chew out		[v]
dress down		[v]
lambaste		[v]
rant			[v]
ream			[v]
upbraid			[v]
renegade		[a]叛变的，变节的
mariner			[n]水手 
gruesome		[a]
primo			
hoot			
divvy			
votive			
pawnshop		
throttle		
must			发霉，潮气，待发酵的葡萄汁
cut-and-dried	
chummy			
wrought			锻造的，加工的，精细的
trickster		
hen-pecked		
rowdy			
fitter			装配工，质检员
maelstrom		大漩涡，极度混乱，不可抗的破坏力
gulf			漩涡，深渊，大间隔；欺骗 
embayment		港湾
estuary			
firth			
fjord			
inlet			
loch			
innards			内脏
mettle			
condensation	
monstrosity		
thereafter		
syllable		
burglar			
bloodcurdling	
screech			
squire			
entourage		随从，周围环境 
cortège			
posse			
splatter		
waltz			
fisticuff		
unison			
coxswain		
blowfish		
chug			
liqueur			
tankard			
cosmetics		[n]化妆品，装饰品
tumble			[v]摔倒，打滚，仓惶
assortment		[n]混合物，分类
hodgepodge		[n]各种各样的混合物
jumble			[v]处于混乱；[n]杂合物，混乱的状态
mélange			[n]由不协调元素组成的混合体
macédoine		[n]混乱体，杂合水果甜点
medley			[n]混乱体
menagerie		[n]用于培养并训练动物以供参观的地方，混合体
miscellanea		[n]混合体
montage			[n]用于表述某种思想的快速播放的一系列图片形成的产物，生成的产物，混合体
olio			[n]混合物，混合体
olla podrida	[n]什锦菜，各种各样的混合物
pastiche		[n]混合曲；东拼西凑
patchwork		[n]拼接物
potpourri		[n]百花香，大杂烩，杂曲
smorgasbord		[n]<<dietetics>>瑞典自助餐，大杂烩
epiphenomena	[n]<<medical>>附带现象，偶发症状
ascertain		[v]非常确定地发现
antics			[n]滑稽的动作
zany			滑稽的，古怪的；小丑，笨蛋 
madcap			狂妄的，鲁莽的；鲁莽的人
irrevocable		不可挽回的
impetus			动力，冲量
impetuous		冲动的，猛烈的，鲁莽的 
intersection	交集，交叉
bygone			过去的，过时的；过去的事
departed		已故的，过去的
extant			存在的		
lager			慢发酵或冷冻熟的啤酒
perpend			深思，考虑；穿墙石
seaward			向海的
metallurgy		冶金学
grove			小树林
sundry			各式各样的；杂货
mollusk			软体动物
alloy			合金
inscription		题词，铭文
veritable		真实的，名副其实的
artisan			工匠
dent			凹槽；削弱
feedbag			饲料袋
dew				露水，清新
mattress		床垫，褥子
edgewise		沿刀口
rockslide		岩滑
stubble			胡茬
limerick		打油诗
fortitude		刚毅，不屈不挠
ducal			公爵的
hornwort		角苔
meandering		曲折的，聊天的，漫步的（曲折或错综复杂的原因，没有无标或毫无头绪的漫步）
paste			糨糊，黏土，面团，肉酱；涂，敷，粘贴，彻底打败
beech			山毛榉
goatweed		羊角芹
wretch			可怜的人，卑鄙的人
caitiff			胆小鬼；卑鄙的
miscreant		异端的，极恶的
rapscallion		流氓 
scalawag		无赖，流氓 
scamp			流氓；草率行事
scapegrace		恶棍，饭桶
varlet			恶棍，无赖 
molest			骚扰，调戏，干扰
perturb			打扰
derail			出轨，脱轨
dismay			使惊慌，使沮丧，灰心丧气
hagride			梦魇
unhinge			使分开，使发狂
weird out		使烦恼
scram			滚开，快速离开，核反应堆紧急停堆
morrow			将来，翌日，紧接特定活动之后的时间
indebted		负债的，受惠的，感恩的
beholden		处于帮助或礼物的职责中的
dramaturgy		戏曲作法
gripping		扣人心弦的
condottiere		雇佣兵，佣兵队长
changeling		低能儿，偷换后留下来的孩子
bashful			害羞的，腼腆的
stagehand		舞台工作人员
couplet			对联，对句
première		首次上演，首次露面；首要的，最早的
piling			打桩
hose			软管，长筒袜；用软管浇水，痛打
casket			骨灰盒，小容器；装进小箱子
puffin			海鹦鹉
diddle			欺骗，浪费，快速摇动
dally			磨蹭，调情，逗留
dawdle			混日子，游手好闲 
dillydally		磨蹭
whoremonger		拉皮条者
ragged			衣衫褴褛的，参差不齐的
dockhand		码头工人
seaman			水手
footwork		步法
windswept		暴露在风中的
crux			关键，难题
bang away		有毅力地干，持续攻击
beaver			海狸，保护脸下部的护甲，头盔面甲；充满激情地工作
beaver away		充满激情地工作
fag				[n]苦工；疲劳；烟头；对男同性恋的蔑称；[v]努力工作；使劳累
hump			圆形拱起物，驼峰，驼背；弓起，隆起，努力工作，急速前进
hustle			推搡，努力工作，奋力前行，偷窃，兜售；奔忙，努力工作
moil			努力工作，处于持续的鼓动之中；苦力活，迷惑
travail			艰苦劳动，分娩的痛苦；辛苦劳动
furl			叠，卷，收拢
strut			炫耀，趾高气扬；支柱，趾高气扬的状态
trump			王牌，法宝；打出王牌，吹喇叭
plunge			快速插入，突然下落，跳进，陷入；骤降，跳水
mummer			哑剧演员
headlong		轻率的，鲁莽的
cursory			快速且通常肤浅完成的
hotfoot			快速
pell-mell		处于混乱中，用不合理的速度
drive-by		在移动的车辆中实施的，快速肤浅完成的；开车射击
helter-skelter	处于不合适的速度/迷惑或不规律中，处于无计划的状态；不规律的迷惑
studiedly		有计划地，深思熟虑地
bestiary		动物寓言集
knave			流氓，（纸牌）杰克
bay				狗叫；大声叫嚷
codpiece		男裤前面的褶
stipulation		规定，约定，条款，契约
demesne			私有领土
untimely		不合时宜的
precocious		出现或发展过早的，过早成熟的
unseasonable	不合时宜的，反季节的
puberty			青春期，开花期
splendor		光彩，壮丽，显赫
augustness		庄严
splendiferous	特别或炫耀地给人印象的
stately			有高或壮观尊严的，傲慢的，不可接近的，大小上给人深刻印象的
stupendous		了不起的，宏伟的，有令人震惊的大小或伟大的
marmalade		橘子或柠檬做成的果酱
ravine			沟壑，山涧
jackdaw			寒鸦
minimalist		极简抽象派艺术家
goiter			甲状腺肿大
gag				塞住（口），阻止自由言论
satchel			小背包
glum			忧郁的，死气沉沉的
lucrative		有利可图的
fess up			坦率地承认
gluttony		暴食，贪吃
allspice		甜辣椒
havoc			大破坏，浩劫；严重损坏
dollop			团，块；大声坠落
frazzle			磨损，使疲惫
prissy			谨小慎微的，过分拘谨和精确的，过分讲究的
prim			呆板的，一本正经的；显得一本正经，打扮得整整齐齐
euthanasia		安乐死
euthanize		使安乐死
plight			订婚；不幸/困难或警惕的状态
privy			私人的，不公开的；厕所
ammonia			氨
tutelage		指导
navel			肚脐，中心点
trio			三重唱，三人一组
breastplate		胸甲
terrace			平台，梯田
oodles			大量
trinket			小装饰品，不值钱的小玩意
billingsgate	非常不好听的脏话
cast off		抛弃，摆脱，解开（缰绳）
jilt			任性或冷酷无情地抛弃（如情人）
tile			瓷砖，瓦片
remex			飞羽
quill			羽毛，刚毛
agate			玛瑙
scoot			溜走，猛冲
aniseed			[n]<<dietetics>>八角
pogrom			大屠杀
pogonotomy		剃须
excavation		挖掘
unsettling		使人不安的
easterly		东方
incunabulum		古版书
ergo			因此
lobster			[n]<<dietetics>>龙虾
contortion		扭曲，困难
squinch			斜眼看，使蜷缩，退缩，蜷缩，卧倒
squint			斜眼看（出于嫉妒或蔑视）
tract			地带，小册子，由身体许多部分或器官组成的用于实现某种功能的系统，一小块土地，一段时间
pamphlet		小册子，传单
helluva			很难的
sowbugg			巢虫
bundle			捆，束 
coalface		煤层断面
wee				极小的，微量的
infinitesimal	无法计算地小，正无穷小
minuscule		小写字母；非常小的
miniature		缩略版的副本，微型画；处于或表现的小的状态
teeny			小的
weeny			小的
herculean		有超常力量/大小/强度或难度的
mountainous		山多的，大的
planetary		星球的，漂泊不定的，很大的，全球的
epicycle		本轮
prodigious		惊人的，巨大的，奇怪的，不正常的
tremendous		巨大的
prodigy			奇迹，奇才
watered-down	
forte			特长，剑最锋利的地方；大声（用于音乐指挥）
notch			刻痕，峡谷；用刻痕计算
rigor			严格，精确，严重程度，寒冷导致的震颤
asperity		持续的困难或不幸
mortis			尸斑
opium			鸦片
threesome		三人一组
egregious		非常显然地不好的
flagrant		显然不被人接受的，与正确违背以至于不和法律或道德的
hanker			向往，追求
bulb			电灯泡，球状物
scout			搜查，侦察机
mane			鬃毛
chain mail		锁子甲
punitive		遭受/涉及或以惩罚为目标的
insubordination	服从
guerilla		游击队
indubitable		不容置疑的
incontestable	不容置疑的
indisputable	不容置疑的
irrefragable	不能反驳的
unanswerable	无法争辩的
unarguable		无可争辩的
unchallengeable	不可挑战的
unquestionable	毫无疑问的
moot			无实际意义的，未决议的
refutable		可质疑的
whatnot			不可名状的东西
warfare			战争
scrummage		扭打，争球
hayseed			乡巴佬，干草种子
geezer			古怪的人，老家伙
squirt			注射
dame			夫人
peeve			惹恼
outlay			花费，支出
boggle			犹豫，退缩
brigade			旅
codger			怪人
vagabond		流浪的；无业游民
antsy			坐立不安的，焦虑的
foil			挫败，衬托；金属箔，猎物足迹，失败，叶型装饰
heifer			小母牛
shamble			蹒跚，摇晃
sabbath			安息日
smug			自以为是的；书呆子
snivel			流鼻涕，啜泣
outlandish		古怪的，奇异的，偏僻的
sortilege		巫术，占卜
sentry			哨兵
lumberjack		伐木工
freckle			雀斑
solidarity		团结
bezoar			牛黄
wholesale		大规模的，批发的；批发
rawhide			生皮
bivalve			双壳贝
scruff			颈背，后背
scruff			颈背，后背
cobblestone		鹅卵石，原石
dishwater		洗碗水
apothecary		药剂师
dreg			渣，沉淀物 
arenaria		蚕缀属
spook			鬼，幽灵，特工；惊吓，受惊
gown			礼服
sempiternal		永恒的
saphenous		隐静脉的
cobalt			钴
chelated		螯合物（用于治疗铅中毒）
tantrum			坏脾气的一次发作
locale			事情发生的现场
perch			鲈鱼，栖息；栖息，位于
earthworm		蚯蚓
clarinet		单簧管
chime			打钟报时
tempera			蛋彩画
mitt			女士无指手套
husk			果皮，皮，壳，残留物，底层框架；去壳
bolete			牛肝菌
forefront		最前线，前沿
grill			烤
cornmeal		[n]<<dietetics>>燕麦片
tortilla		[n]<<dietetics>>玉米粉薄圆饼
masa			[n]<<dietetics>>玉米面团
fennel			[n]<<dietetics>>茴香
leek			[n]<<dietetics>>韭葱
endive			[n]<<dietetics>>莴苣
penne			[n]<<dietetics>>管状通心粉
orecchiette		[n]<<dietetics>>小耳朵形状的意大利面
farfalle		[n]<<dietetics>>蝴蝶结意大利面
radiatori		[n]<<dietetics>>有褶边的意大利面
gyro			[n]<<dietetics>>希腊肉卷三明治
macaron			[n]<<dietetics>>杏仁小圆饼
macaroon		[n]<<dietetics>>蛋白杏仁饼干
panini			
pfeffernüsse	[n]<<dietetics>>圣诞小酥饼
shortbread		[n]<<dietetics>>酥饼
lox				[n]<<dietetics>>熏鲑鱼
mackerel		[n]<<dietetics>>鲭
ceviche			[n]<<dietetics>>酸橘汁腌鱼
herring			[n]<<dietetics>>鲱鱼
durian			[n]<<dietetics>>榴莲
mangosteen		[n]<<dietetics>>山竹
lychee			[n]<<dietetics>>荔枝
jackfruit		[n]<<dietetics>>菠萝蜜
sanshool		[n]<<dietetics>>花椒素
peppercorn		[n]<<dietetics>>干胡椒
anise			[n]<<dietetics>>大茴香
barberry		伏牛花
ponzu			[n]<<dietetics>>用酱油和柑橘做成的寿司蘸料
roux			[n]<<dietetics>>用于熬汤的乳酪面粉糊
Béchamel		[n]<<dietetics>>调味酱
Hollandaise		[n]<<dietetics>>用奶油/蛋黄和酸味剂（柠檬或醋）做成的荷兰汁
flatbread		[n]<<dietetics>>面包干
matzo			[n]<<dietetics>>犹太逾越节期间吃的不发酵的面饼
griddle			矿筛，煎饼用的锅；煎
injera			[n]<<dietetics>>埃塞俄比亚发酵白面包
Amharic			埃塞俄比亚官方语言
Malay			马来语
jettison		为减轻重量而丢弃，由于其他的决策而丢弃多余的东西或累赘
cashier			管钱的人；管钱，丢弃，从服务中解散，不光彩地解散
shuck			壳，果壳，外壳，（复数）没什么价值的东西；去壳，（shuck off）丢弃
frippery		华丽炫耀的装饰，显摆但不值钱的东西，愚蠢的装饰
caparison		马衣，装饰品；装饰 
regalia			皇室特权，皇室象征或用品，用于代表身份的装饰或徽章，华丽炫耀的服饰
prerogative		特权
appanage		封地，封禄
grimoire		用于召唤恶魔或死灵的魔法书
garb			服装，打扮
aqueous			水的
countermeasure	用于否定或取消另一个行为的行为或设备
jowl			颌，颚骨，面颊；敲钟
magnate			巨头，大资本家
tycoon			有重大影响/财富/权力的人，政治领袖，（日本）将军
disgruntled		不满的
liquidation		清算，清除
travelogue		旅行见闻讲演
larder			食品室
mea culpa		我的错
ruse			策略
subterfuge		迷惑策略从而藏匿/逃跑/躲避
chicanery		通过有技巧的骗术欺骗，把戏
chicane			骗术，一手牌中缺少王牌，赛马场上的障碍物；欺骗
sophistry		
gamesmanship	通过令人质疑且不违反规则的策略获胜的艺术或行为，使用伦理上可疑的方法来获取目标
hanky-panky		令人质疑或不见光日的活动，调情 
legerdemain		技巧或灵敏的展示，巧妙执行的把戏
sleight of hand	巧妙执行的把戏或骗术，需要手上灵敏度的骗术
prestidigitation		变戏法
skulduggery		卑劣的或肆无忌惮的行为，骗术，欺骗性的装置
finagle			通过不直接或不介入的方式获取，通过诡计获取
renege			违背约定或承诺，撤回，否认，宣布废弃
back down		背弃承诺或职位
back off		背弃承诺或职位
back out		背弃承诺或职位
cop out			背弃承诺或职位
fink out		背弃承诺或职位
pretext			所谓的目的或动机（用于隐藏真实目的）
eschew			习惯性躲避（尤其是道德或实践性）
renounce		垫牌
revoke			有牌不跟
go back on		违背，食言
halberdier		戟兵
downtrodden		被践踏的，受压迫的
strumpet		妓女
bonfire			篝火
grapple			抓住，格斗；格斗机
pontificate		教皇；目空一切
steed			用于骑的马
viceroy			有统治权的省长或总统
tulip			郁金香
turban			穆斯林的头巾
facet			问题的方面，切割的宝石的一个小平面，划好界限的平缓表面
ommatidium		[n]<<entomology>>（昆虫）小眼
spew			呕吐，以洪水的形式大量涌现，像受到压力一样漏出；呕吐物，漏出物
spout			以流的形式喷射液体，流畅地说或表达，慷慨陈词；用于流液体的管子或容器，排水口
waterspout		排水口
gush			涌出
spurt			涌出，排除液体或气体；突然的一次排放，一小段时间，效果/活动/发展的一次短促爆发，商业活动的突然增长
faucet			旋塞，水龙头
swoosh			嗖嗖移动，形成漩涡；嗖嗖声
dribble			零星小滴地排出，轻拍或轻弹地促进，成股流下，流口水；很小或不重要的数量
piecemeal		断断续续的；一点一点，成碎片状
desultory		断断续续的，散漫的，不连贯的
quibble			用挑剔用词的方式逃避议点，挑剔用词，斗嘴；逃避话题，小争论或批评
niggle			计较细节，过分挑剔，折磨；恼人的怀疑/反对/抱怨
nitpick			吹毛求疵，挑剔
bicker			斗嘴；争吵，闪动
altercation		恼人且生气的争执，嘈杂的争论
rickety			摇晃的，身体不健康的
impeach			控告有罪或行为不雅，弹劾，怀疑，挑战可信性或真实性
skald			吟游诗人
gaggle			鹅群，咯咯叫
incriminate		控告，指控有罪
genealogical	系谱的
entropy			熵，混乱
pollard			去梢，去角；去角的动物
piggyback		驮运
liege			君主
mutiny			兵变，叛乱
insurrection	叛乱
murky			抑郁的，朦胧的
caliginous		模糊的，阴暗的，晦涩的
pitchy			（音乐音调）有点太高或太低，（声音）令人不悦地高或刺耳
somber			被掩盖以至于阴暗，沉重的，抑郁的，传达抑郁暗示或想法的，灰色调的
stygian			与冥河有关的，非常压抑或令人厌烦的
tenebrous		阴暗的，难以理解的，使人抑郁的
temerity		轻率，对危险或反对无理由或愚蠢的藐视
audacity		轻率（不顾惯例或谨慎的束缚）
effrontery		厚颜无耻，不讲礼貌
saucy			鲁莽的，傲慢的
pierogi			[n]<<dietetics>>半圆形小酥饼
ruffian			恶棍，流氓
bemoan			惋惜，叹息
bewail			哀悼，痛哭
deplore			哀悼，谴责
bland			乏味的，平和的，味道不浓郁的
saber			军刀，佩剑
gurgle			汩汩声；汩汩流动
slop			液体溢出，漫不经心地涂或敷
heave			举起，投掷，恶心，发出叹息；起伏，一阵呕吐
onward			向前的；取得进步
hollow			空的，中空的，虚伪的；完全地，空洞地
otiose			徒劳的，闲着的，没用的
nugatory		不产生后果的，没有力量的
muffle			裹住，蒙住，抑制
courtier		朝臣，谄媚者
triadic			三人一组的，三色系
hyphen			连字符
cardinality		[n]<<mathematics>>基数
lattice			[n]<<mathematics>>格，<<chemistry>>晶格
throughput		吞吐量
multiplexing	多路复用
hocus-pocus		欺骗；花招，骗术
unbeknownst		不为所知的；不为所知 
prowess			英勇，军事勇气和技巧，超凡的技巧
decadent		颓废的；颓废的人
assuage			平息，缓和
tribal			部落的，种族的
maladjusted		失调的，不适应环境的
therein			在其中，在那里
frumpy			衣着过时的，单调乏味的
doctorate		博士学位
portend			预示，预兆
feckless		软弱的
notwithstanding	尽管
suffrage		选举权，投票
suffragette		妇女参政权论者
drop-dead		非常美丽的
ravish			强奸
ravishing		引人入胜的
beauteous		非常美丽的
gibbous			突起的，（天体）凸圆的
heartstring		心弦
teem			充满，大量出现
mettlesome		勇敢的，精神饱满的
ratiocination	推论，推理
wiseacre		自作聪明的人
prescind		割开，独立思考
bardolater		崇拜莎士比亚的人
photog			摄影师
lensman			摄影师
shutter			百叶窗，快门
shutterbug		摄影爱好者
tabloid			小报，八卦小报
demotic			通俗的，民众的
malinger		装病以逃避工作
venal			贪污的，用金钱购买的
syllogism		三段论
anagram			回文构词法
succinct		简洁的
eyepiece		目镜
lens			镜头
telecast		电视广播
gaffer			[n]乡下老头
booty			[n]战利品，赃物
incandescent	[n]白炽灯；辉煌的，炙热的
miscast			[n]角色分配不当
oeuvre			[n]<<French>>全部作品，毕生之作
phosphorus		[n]<<chemistry>>磷
reservoir		水库，蓄水池
silt			淤泥
runoff			径流
legume			豆科植物
debar			阻止，排除
elicit			引出，得出
grain			粮食，谷粒
preside			主持，管理，担任会议主席
syrup			糖浆
barley			[n]<<dietetics>>大麦
pachyrhizus		[n]<<dietetics>>地瓜
tamper			做手脚，篡改；打夯机
demote			使降级
relegate		降级
dissipate		浪费，使消散
inane			空虚的
flimsy			脆弱的，薄的
insubstantial	脆弱的，不真实的
wanderlust		流浪癖
sectarian		宗派主义者
soporific		催眠的；安眠药
valiant			英勇的人；英勇的
hurl			用力抛，丢弃
motley			混杂的，杂色的
menace			恐吓，威胁
replete			充满的
interplay		相互影响
hearten			激励，振作，使振作
mortify			抑制，苦行，约束，使受侮辱
antecedent		先行词，祖先
tenet			原则，信条
negligent		粗心的，疏忽的
perfidy			不诚实，背信
perfidious		不忠的
scamper			蹦蹦跳跳，快速逃走
bemuse			使发呆，使困惑
tenacious		顽强的
stark			荒凉的，光秃秃的，朴实的，完全
retentive		记忆力好的
effete			[a]衰老的；不再生育的；失去活力的
dabble			涉猎，涉水
streak			条纹；疾驶，快速跑
titular			有名无实的
enact			颁布，扮演
rampant			猖獗的，蔓延的，奔放的
forlorn			被遗弃的
hover			盘旋，徘徊
forbear			忍耐，克制
paltry			微不足道的，无价值的，劣质的，不愉快的
turnip			[n]<<dietetics>>萝卜，大头菜
liverwurst		[n]<<dietetics>>德国猪肝肠
bushel			修整衣物
drape			窗帘；用帘覆盖
nymph			女神，居于山林水泽的仙女，美丽的少女
shat			排出粪便
cocked ear		竖起的耳朵
surfeit			过度饮食，由于过度饮食而恶心，过分沉溺，放纵
gaunt			憔悴的，荒凉的 
moth			蛾，蛀虫
aspersion		中伤，诽谤
dauphin			法国皇太子
splurge			挥霍，卖弄，炫耀 
mausoleum		陵墓
upturn			情况好转
hoist			起重机；升起，吊起
blister			水疱；痛打 
revel			狂欢，陶醉
ruck			褶皱，普通人，大量；弄皱
unwashed		不干净的，平民百姓的，下层人民的
grin			露齿而笑
hedgerow		灌木篱墙
hayloft			干草棚
loin			[n]<<dietetics>>腰，腰肉
pederast		好男色者
newlywed		新婚的；新婚夫妇
capping			遮盖物
frolic			嬉戏；快乐的 
overlade		超载
rhubarb			大黄，大黄叶柄，喧哗
rowan			欧洲山梨
wondrous		奇妙的，非常的
spry			活泼的，敏捷的，充满生气的
sly				狡猾的，淘气的 
ilk				类型，同类；相同的
bumpkin			土包子，乡巴佬，土老帽
slackjawed		发呆的
yak				耗牛，喋喋不休
kink			扭结，奇想，蜷缩；使扭结
foretaste		试吃，期待 
lunge			刺，戳，猛冲；驯马索
souse			[n]<<dietetics>>卤汁；腌制，喝醉，沁入水中
belcher			有大白点的蓝色围巾
bairn			小孩 
stein			一品脱容量的酒杯
puffy			肿胀的，过分修饰的；眼袋
cuckold			妻子有外遇的人
caff			（非正式）小餐馆
fiddler			拉小提琴的人，骗子，游荡的人
unbending		坚定的，冷漠的
gash			很深的裂缝，很深的伤口；砍入
multilated		残缺不全的
strew			散播 
lurid			可怕的，耸人听闻的
wind-up			令人恼怒的话，投球手的挥臂动作
fraternize		结交兄弟，友善
broomstick		扫帚柄
exotica			新奇事物
tae				朝，向 
preferential	优先的，优惠的
promissory		约定的，许诺的，约定支付的
jotun			巨人
ignoramus		无知的人
sumptuous		华丽的，奢侈的 
pinchfist		守财奴
tong			钳子，帮会
intermission	幕间休息，暂停
irksome			令人厌烦的
faux			人造的，假的
oversight		疏忽 
composure		镇静
rump			臀部 
lecherous		好色的，淫荡的
farmstead		农庄
safecracker		保险箱窃贼
tightrope		拉紧的绳索
cinch			肚脐，必定的事，极其容易的事情；用带子系衣服，确保
saltpeter		硝石，硝酸钾
fink			卑鄙小人；向警方告密
clover			三叶草
chowder			[n]<<dietetics>>海鲜杂烩汤
gumption		进取心，精明强干
gruel			[n]<<dietetics>>燕麦粥
porphyritic		斑岩的
restoration		政权复辟
henbane			天仙子
dictum			格言，声明，法官的附带意见
uncouth			笨拙的，粗俗的
wilt			使枯萎，使凋谢
sleet			雨夹雪
droop			下垂，凋谢
loll			诱惑，虚度光阴，松散地悬挂
dangle			摇晃地悬挂，在某人面前晃从而诱惑
sag				中间下垂，松弛，衰退，下跌，萎靡
macabre			可怕的，以死亡为主题的
toilsome		辛苦的，费力的
sketchpad		画板
inter			埋葬
disinter		挖掘，显露
hearse			棺材，灵车；埋葬 
inhume			埋葬 
tableware		餐具
birthright		与生俱来的权利，长子继承权
tatter			碎布，碎纸；扯碎
fizzle			失败，发出嘶嘶声
convenant		契约，婚约
upkeep			维持，维护费
irresistible	不可抵抗的，非常诱人的
lamen			挽歌，恸哭
sigil			魔印
bedpan			便盆
outcast			流浪的人；被驱逐的，无家可归的
pariah			被驱逐的人
elope			私奔，逃亡
cryonics		人体冷冻
vitrification	玻璃化
cyanotic		青紫的
umbilical		脐带的
neonatology		新生儿科
viscosity		粘液，粘度
rusty			迟钝的，生锈的
cortisol		皮质醇
cortisone		肾上腺皮质酮
machination		阴谋
nonrefundable	不可归还的
guesswork		猜测，臆测
appertain		属于，有关，适用
ogle			抛媚眼
oktoberfest		十月节，啤酒节
skitter			快速滑行或跳过，不平稳地走，沿水面抽鱼钩
jerky			不平稳的，抽筋的；干肉条
jittery			神经过敏的，战战克克的
glide			滑行，悄悄走
brethren		兄弟，同胞
formic			蚁酸的
urtica dioica	大荨麻
reconnoiter		侦察，勘察
mincemeat		水果馅
umbrage			不快，树荫，怀疑
hurtle			猛冲
otherworldly	来世的，超凡脱俗的
otherworld		来世，冥界
landslide		山崩，大胜利；压倒性优势获胜
flurry			慌张，疾风
pincer			钳子，拨钉钳
prehensile		善于领会的
sodden			浸透的；使浸透，使迷糊
unfrequented	人迹罕至的
behemoth		巨兽；巨大的 
partridge		松鸡
guzzle			狂欢，暴食 
lodging			寄宿处
marauder		掠夺者
fanfare			吹牛，号角齐鸣
nefarious		邪恶的
hobnail			鞋钉
monogram		交织文字
musty			发霉的，冷淡的
pâté			秃顶 
petty			琐碎的，小气的
troth			诺言，婚约 
bob				
gallivant		与异性闲逛
outrage			愤怒，暴行，侮辱；强奸，施加暴行
bunk			床铺；逃课
rabble			乌合之众，暴民，下层社会，长柄耙；聚众闹事，用长柄耙搅拌
tush			犬齿，獠牙
rehash			重复使用，缺乏创意地改变
picky			挑剔的
fishy			可疑的，呆滞的
tactless		不机智的，笨拙的 
saucepan		炖锅
sprig			小枝，图钉
bouillon		牛肉清汤
stewpot			炖锅 
simmer			炖，充满愤怒，酝酿，即将爆发
dill			莳萝
tablespoon		大汤勺
bunch			群，串，突出物
homage			敬意，效忠
fatback			背部肥肉
marjoram		马郁兰
helm			舵；掌舵，指挥
strongman		铁腕人物
camerlengo		财政官，天主教侍从
ringworm		癣
crevasse		裂缝，破口
ointment		药膏
batter			击球手，狂欢，字面磨损；形成 坡度，连续猛击
villainy		邪恶，坏事
gladiator		阔剑，斗剑者
seep			泄露，渗透
rescind			解除，撤回
grim			冷酷的，残忍的 
pillory			木枷；抨击，嘲笑，公开批评
cutpurse		扒手
nightshirt		夜班，夜班工人
misdoing		坏事，做错
numismatics		古币学，钱币学
knit			编织
tipsy			喝醉的，摇晃的
winkle			套出信息
wrinkle			皱纹
skittish		轻佻的，善变的，不安的，易受惊的
toffee			[n]<<dietetics>>太妃糖
prithee			[int]请
bestial			兽性的，野蛮的
makeshift		权宜之计；临时的
fallow			休耕的，不活跃的
enclose			围绕，封入
unrivaled		无敌的，无与伦比的 
virility		男子气概 
unparalleled	无双的，前所未有的
enthuse			充满热情，兴奋地说
romp			玩耍，轻易获胜
beanpole		用于给豆藤爬的杆，瘦高的人
centipede		[n]<<entomology>>蜈蚣
subterranean	地下的，秘密的；地下工作者
scolopendromorpha		[n]<<entomology>>蜈蚣属
heirloom		传家宝
albumen			[n]<<biology>>蛋白，胚乳
festoon			结彩
raftsman		撑筏者
wagonload		一货车的货物
populace		大众，平民
harlot			娼妓
noisome			恶臭的，有害的 
scallywag		饭桶，流氓 
underprice		低价竞争
plonk			重物落下的声音
botch			糟蹋，笨拙地修补
scenic			风景优美的；风景胜地
glade			树林环绕的开阔地方
muster			召集，点名；点名册，集合人员
podium			乐队指挥台，领奖台，矮墙
garter			袜带
heron			苍鹭
trounce			痛打，严责
interim			临时的；过渡时期
stellar			星的，一流的
prose			散文，单调；乏味的；乏味地讲话
affront			冒犯，公开侮辱
peep			窥视，偷看
oriole			[n]<<biology>>金莺
onset			开始，发动攻击
distraught		发狂的，伤心的
cormorant		[n]<<biology>>鸬鹚，贪婪的人；贪婪的
skirmish		小冲突，小争论；发生冲突
skirmisher		散兵
roster			花名册，执勤人员表
grievous		痛苦的，剧烈的
infamy			声名狼藉
droll			滑稽的；小丑；开玩笑
canoe			独木舟
millennial		一千年的
patio			露台，天井
achiote			[n]<<biology>>胭脂树
jalapeño		[n]<<dietetics>><<Mexican>>墨西哥胡椒
helitanker		消防直升机
scotch			结束，破除，楔入，切割表皮；刻痕，伤口
sadistic		施虐狂
rank			[a]讨厌的，恶臭的；繁盛的
truffle			[n]<<dietetics>>松露，巧克力糖
lubber			傻大个
nosey			好事的
earmuffs		耳塞，护耳
freestanding	不需要支撑物依靠的
pointillistic	点彩派画家；点彩派的
mademoiselle	[n]<<French>>小姐
riposte			[n]<<French>>反击，机智的应答
inbreed			天生，与生俱来 
queasy			呕吐的，反胃的
testy			易怒的，烦躁的
tinkle			叮当声
madame			夫人，太太
bon vivant		好交际且有很好食物品味的人
sprawl			无序地伸展，伸开四肢地坐或躺；四肢张开的姿势，杂乱的城市
flutter			[v]快速地拍打翅膀，不规则地振动，慌张无目标地移动或行为；[n]这样的行为，暴动，混乱或兴奋的状态，身体不问的不正常痉挛性颤动，受自然因素影响而产生的不被期望的震动
eyelash			[n]睫毛，一发之差
hairbreadth		[n]非常小的距离或边缘；[a]非常窄的
hairline		[n]非常窄的线，非常小的距离，只有一条线宽的横向或纵向的纺织物设计，有这样设计的纺织物，发际线，头发给脸定性的方式
mutton			[n]<<dietetics>>用于食用的成熟羊的肉
molt			[v]脱毛/羽毛/壳/角或者其他表层，周期性脱壳（常用于节肢动物）；[n]这样的行为或过程，脱皮
ecdysis			脱去表层的行为
adytum			古时只对牧师开放的最深处神秘的圣堂
innermost		[a]最深处的；[n]最深处的部分
inmost			[a]最深处的，距外层最远的
slough			[n]沼泽地，河流的入口，死水，沼泽或平地中的小溪，道德或精神沦丧的状态；[v]陷入沼泽，淌过（沼泽）；[n]给蛇脱皮，一大堆坏死的阻止，蜕皮时蜕掉的东西；[v]去皮，慢慢崩溃或瓦解，挣脱，（off）把令人厌烦/引起质疑/不好的部分丢弃，（桥牌输掉一局时的）弃牌
shed			[v]脱去不想要的部分，从植物或动物身上取出，成滴留下，丢弃，由于受伤而流血，使分开，驱散，洒；[n]丢弃的东西，土地分割；[n]用于保存或掩体的建筑，没有围起来的单层建筑；[v]住在这样的建筑中
confit			[n]<<dietetics>>利用自身脂肪做好的肉（鹅肉/鸭肉/猪肉），通常用水果或蔬菜做到只剩液体程度而制成的配菜
rillettes		[n]<<dietetics>>用脂肪保存的做好的切碎的肉（猪肉/鸭肉）
tramp			[v]略；[n]漂流者，远足者，妓女，步行旅行，用于保护鞋底的铁板；[a]没有住所/联系人/目的地的
jaunt			[n]短途旅行；[v]这样的旅行
trudge			[v]费力地行军；[n]令人疲惫的长途旅行
scrounge		[v]偷，通过借/搜寻/拾荒的方式获得，（up）哄骗，通过一切渠道以获取
swipe			[n]强有力的一扫，锋利而关键���言词；[v]扫的一击，偷，刷卡
pilfer			[v]小数目一次又一次地偷
plump			[v]突然或沉重地丢下/沉没/联系，强烈地帮助（for）；[n]突然的掉落/摔倒/一击，这样的声音；[adv]径直向前，伴随这样的掉落；[a]肥胖且招人爱的
blubber			[v]大声地哭；[n]鲸或其他哺乳动物的脂肪，身体的过量脂肪，大声哭
pudgy			[a]短小而粗胖的
rotund			[a]圆的，声音或韵律饱满的，显著地肥胖
orotund			[a]声音饱满/有力/清晰的，浮夸的
sonorous		[a]产生声音的，声音大的，在效果或风格上给人印象的，响度大的
sonority		[n]响度
fillip			
clout			
wham			
spank			
thud			
cuff			
dab				
douse			
pelt			[n]去毛的兽皮（通常是羊皮）；用于制革的去毛的皮；[v]对动物去毛；[v]连续打击；对目标投掷；[n]打击
full pelt		<<British>>全速
lick			[v]舔；连续打击；击败;[n]一次打击；自然的有盐储备的地方；用于给牲畜吃的含盐的东西；一种即兴发挥的音乐手法；很明显的凹进
lick and a promise		对任务的不怎么样的表现
get in one's lick		
lick into shape	使有更好地形式或状态
lick one's chops		垂涎欲滴
lick one's wounds		从失败或失望中恢复
snatch			
cahoot			（in cahoots）合伙，同伙
afresh			
flatulence		[n]胀气，自负
milksop			
ingrate			
yoke			
cackle			
shrew			
heathen			
harangue		[n]公开演讲，咆哮状态的讲话或行文，讲座；[v]公开演讲
diatribe		[n]挖苦或批评性的话或文，讽刺
satirical		[a]讽刺性的
satire			[n]讽刺，用来暴漏和使小错误丢脸的强烈批评
lampoon			[n]挖苦；讽刺写作
pasquinade		[n]讽刺性笔法；公开挖苦
parody			[n]对文学作品或音乐的滑稽的模仿；[v]
trenchant		[a]
discredit		
jeremiad		
philippic		
tirade			
descant			
expatiate		
folly			[n]
immaculate		
heretic			
smarmy			[a]展示或被自以为是/迎合讨好/假正经标记的，品味或质量低俗肮脏的
sleazy			[a]不结实的，粗制滥造的，低品质或性格的，毁坏的 
squalid			[a]由于被忽视或贫穷而被肮脏或下流标记的
sordid			[a]卑鄙下流的，肮脏的，自私贪婪的，颜色不鲜艳的
shoddy			[n]长毛，软再生毛；[a]劣质的，便宜仿制的，下流的，破烂肮脏的
slut			[n]泼妇
eroticism		[n]性的兴奋，性欲亢进，性爱倾向
marital			[a]婚姻的，夫妇间的
polecat			[n]臭鼬
puff			[n]烟，一阵风，吹捧额文章，吹嘘，广告；[v]喷开，膨胀，喷漆前进，骄傲自满
pomade			[n]润发油
foolproof		[a]十分简单的，可靠不会出错的
jiffy			[n]一瞬间
trice			[n]一瞬间；[v]用短绳子吊起
paragon			[n]完美的示范；[v]匹敌
beau ideal		[n]完美的模型
exemplar		[n]理想的模型，特别品种，抄本
eidolon			[n]幻象，理想模型
nonesuch		[n]无可匹敌的人或事物
nonpareil		[a]无可匹敌的；[n]无可匹敌的个体，多种颜色的小糖球，一小片被白色糖球覆盖的巧克力
patron saint	[n]守护神，原始模型或领导
shellacking		[n]决定性胜利
overthrow		[v]推翻，颠覆，击败
plastering		[n]塑料外皮，决定性胜利
trimming		[n]附加的食物装饰物，附加装饰物，修建某物后的残余，击败
whipping		[n]严重击败或惩罚，小针脚缝合，用于包扎或加固的材料
overcast		[v]使暗淡，用长斜面缝以防解开
ravel			[v]解开（线圈），分崩，碎，降低混乱程度，使混乱；[n]这样的动作或结果
luscious		[a]甜的，性的，色诱的，非常奢华或吸引人的，过分装饰的
scrumptious		[a]令人愉悦的，很好的，美味的
physiognomy		[n]相面术
en face			[n]正面
wink			[v]快速眨眼好像在发信号或调情，避免看见（at），断断续续地闪动，结束（out），停止闪动（out），用光发信号；[n]一段时间的失眠，这样的行为，一瞬间
siesta			[n]下午觉
epilepsy		[n]癫痫
tenanus			[n]破伤风，强直
scrotum			[n]阴囊
compartment		[v]分割，划分；[n]火车上的小客房
compartmentalize		[v]划分
trimester		[n]三个月的一学期
bunker			[n]用于存储的箱子或单间，用于存储船燃料的舷侧，保护性的路堤或防空洞；[v]把船存储间填满煤或油，用这样的屋子存储
embrasure		[n]用于射击的墙的向外开口或防御工事的矮墙，窗或门的凹处
shipboard		[n]船，船的一侧
dugout			[n]挖空一个大木头而制成的船，山腰的避难所，在地方用草皮做屋檐的小屋，棒球场边供球员休息的地方
baseball diamond		[n]棒球内场
presto			[interjection]用于表示魔术的瞬间出现；[a][adv]像变魔术一样快，（音乐指示）快节奏；[n]快节奏音乐
genitalia		[n]生殖器，外阴部
gingerly		[a]谨慎的；[adv]谨慎地
apace			[adv]以快步伐，肩并肩（of, with）
pronto			[adv]没有延迟地
sacrament		[n]圣礼，圣餐
convent			[n]由宗教命令或聚集组成的当地社区
vexillology		[n]旗帜学
oxymoron		[n]矛盾修饰法
stricture		[n]身体通道的不寻常狭窄，在产生语音时对呼吸通道的收缩，限制，有敌意的批评
censure			[n]谴责，批评
commination		[n]斥责，谴责
excoriate		[v]磨掉表皮，严厉地责难
scathe			[n]伤害，损伤；[v]使受伤，灼烧，猛烈抨击
withering		[a]毁灭性的
assail			[v]攻击，遭遇/攻击/正面攻击，强烈反对/挑战/批评
potshot			[n]从埋伏处的对一个随机或容易击中目标的一击，以随机或零星方式做出的批评；[v]进行一次这样的攻击
scathing		[a]严厉的，激烈的
snarky			[a]急躁的，无常的，用讽刺/无礼的语气或礼节
impertinent		[a]不恰当的，不相关的，无礼的
peevish			[a]易怒的
perverse		[a]倔强的，不正当的，违背常理的
snappy			[a]活跃的，做事快的，冷冰冰的
waspish			[a]像黄蜂一样的，暴躁的，苗条的
wasp			[n]黄蜂
belabor			[v]用语言攻击，重打，过度地表达或坚持
harp			[n]竖琴，口琴；[v]弹竖琴，（on）单调乏味地重复一个话题
casework		[n]涉及直接考虑个别个案(如个人或家庭)的问题、需要及调整的社会工作
workbook		[n]工人手册，作业本，包含多个电子制表的单一文件
spreadsheet		[n]电子表格
crockery		[n]陶器，瓦器
cider			[n]苹果汁，苹果酒
atole			[n]煮成糊状或稀粥的玉米粉
hotshot			[n]快速运输，被公认有能力或成功的人
leash			[n]皮带；[v]束缚
nightstand		[n]床头柜
night table		[n]床头柜
amethyst		[n]紫水晶，中等紫色
wormhole		[n]虫洞
treetop			[n]树顶，树梢
driveway		[n]临近地面的私人车道
petechiae		[n]瘀点
premortem		[n]事前验尸
ligature		[n]结扎，绷带
intradermal		[a]皮肤内的，真皮内的
belle epoque	[n]一段艺术或文化的高度发展，法国19世纪末的这样一段时间
fin de siècle	[a]与文学艺术氛围/厌世/上层社会绝望有关的接近19世纪末的，世纪末的
seethe			[v]沸腾，激动，冒泡
doughy			[a]半熟的，迟钝的 
standpoint		[n]立场，观点
tertiary		[a][n]第三纪
reflexive		[a]自反的，反身的，反射的
sledge			[n]雪橇，大锤
sled			[n]雪橇
sledgehammer	[n]双手大锤；[v]用大锤打
hiss			[n][v]嘘声
squish			
squishy			[a]黏糊糊的，湿软的
stub			
mangle			
shove			
tendril			[n]卷须，蔓 
doorstep		[n]门阶
crème brûlée	[n]<<dietetics>><<French>>焦糖布丁
trove			[n]宝藏，宝库
fiddle			[n]小提琴
swaddle			[n]襁褓，绷带；[v]束缚，裹住
fritz			[n]机器出故障
on the fritz	出故障
cheesy			[a]破烂的
plush			[n]长毛绒；[a]长毛绒的，豪华的
rad				[n]辐射剂量单位
pout			[n][v]噘嘴，闷闷不乐
punch line		[n]故事中的关键句
majestic		[a]庄严的，宏伟的
clingy			[a]紧贴的
misfit			[n][v]不适合环境的人
hippie			[n]嬉皮士
squat			[n][v]蹲坐，蹲牢
invoice			[n][v]发票，委托寄售商品
munchies		[n]小点心
detox			[n]排毒
smoothie		[n]<<dietetics>>奶昔
conjunctivitis	[n]<<medical>>结膜炎
measles			[n]<<medical>>麻疹
cabby			
cricket			[n]板球
slippage		[n]滑动
Sazerac			[trademark]<<dietetics>>
blimey			[interj]表达惊讶或困惑
Gorblimey		[interj]<<British>>表达惊讶或困惑
contender		[n]争夺冠军或最高荣誉的竞争者
uncalled		[a]未被邀请的
brioche			[n]<<dietetics>>奶油蛋卷
redact			[v]编辑，记下，从公开资料中去除
juicy			[a]经济回报高的，多彩的，生机勃勃的
civvy			[n]能区分与特殊服装的平民服装，平民
enquiry			[n]<<British>>inquiry
inquiry			[n]询问，对公共兴趣的系统性调查，研究
mosque			[n]清真寺
wig				[n]假发；[v]斥责
toupee			[n]（男用）假发
fob				[n]表袋，钥匙链，钥匙链上的挂饰			
cassette		[n]磁带盒
flippant		[a]不严肃的
trawl			[n]用于放到海底部打捞的大型圆锥形渔网；[v]打捞，用鱼饵捕捞
lymphoma		[n]<<medical>>淋巴瘤
deepfake		[n]录音或图像的伪造
frontal			[n]房屋的正面，额骨；[a]额的，正面的
quirk			[n]突然扭曲，特别特性，从相邻的构件中分离出珠子或其他模子的槽；[v]扭曲
idiosyncrasy	[n]特征，癖好
mannerism		[n]特殊习惯
preciosity		[n]不易满足的精度
mascot			[n]吉祥物
periapt			[n]护符
sidewalk		[n]人行横道
c-spine			[n]<<anatomy>>cervical spine
flaunt			[n][v]炫耀
Mick			[n]（贬义）爱尔兰人
borough			[n]自制市
fakery			[n]伪造，伪造品
ward			[n]病房，守卫
cicada			[n]蝉
imposing		[a]令人印象深刻的，壮观的，令人生畏的
copycat			[n]盲目的模仿者
quartet			[n]四重奏，四个一组的东西
pavor nocturnus	[n]夜惊
night terror	[n]夜惊（在慢波睡眠中儿童在迷乱的恐惧中的突然醒来，通常在此之前会听到在睡眠中突然发出的尖锐的叫声，而且当孩子醒来时就不记得了）
safari			[n]旅行，远足，非洲东部打猎探险的部队和装备
ketamine		[n]克他命，K粉
convertible		[n]敞篷车；[a]有敞篷的，可转化的
vintage			[n]葡萄园的葡萄或葡萄酒产量，每年最好的葡萄酒，产量，收获葡萄的时间，生产或发源的一段时间，年龄；[a]古典的，旧的，过时的，最佳的
contemporaneous	[a]同一时期的
oldfangled		[a]过时的
fangle			[n]浮华或愚蠢的时尚；[v]用...装饰
weepy			[a]易哭泣的
donovanosis		[n]<<medical>>腹股沟肉芽肿
mace			[n]一种由干的肉豆蔻外部纤维状覆盖物组成的芳香香料，用作武器的棒子，骨棒，狼牙棒
clearance		[n]清理，清洁，肾清除率
pinpoint		[n]非常小或微不足道的东西，针尖，尖锐的小东西；[a]非常精确的，非常细小的
burrito			[n]<<dietetics>><<Mexican>>
egotistical		
ulcerative tinea pedis		[n]<<medical>>溃疡性脚癣
chlamydia		[n]<<biology>>衣原体
lumbar			[n][a]<<biology>>腰，腰神经，腰动脉
heparin			[n]<<medical>>肝素
aneurysm		[n]<<medical>>动脉瘤
resect			[v]切除
rejuvenation	[n]使恢复活力，返老还童
circumcise		[v]<<medical>>割包皮
prepuce			[n]<<anatomy>>包皮
clitoris		[n]<<anatomy>>阴蒂
labia minora	[n]<<anatomy>>小阴唇
metacarpophalangeal		[a]<<anatomy>>掌骨和指骨的
metacarpal		[n][a]<<anatomy>>掌骨
genitalia		[n]<<medical>>外部生殖器官
metastatic		[a]<<medical>>（肿瘤）转移的
lesion			[n]<<medical>>损害，病变
jejunum			[n]<<anatomy>>空肠
tenotomy		[n]<<medical>>腱切割术
discretionary	[a]由个人想法决定的
fallout			[n]放射性微尘，持续性后果
fall out		[v]争吵，结果是，在排名中弃权，脱落
oblate			[a]扁圆的，奉为神圣的
dweeb			[n]白痴，笨蛋
masseter		[n]<<medical>>咬肌
celiac			[a]<<medical>>腹腔的
priapism		[n]<<medical>>阴茎异常勃起
condominium		[n]公寓
spasm			[n]痉挛
flextime		[n]弹性工作时间
arraign			[v]在法庭上对被告提问，控告
señora			[n]夫人
forcep			[n]钳子
calcaneus		[n]<<anatomy>>跟骨
cervical		[a]<<anatomy>>颈的，子宫颈的
fistula			[n]<<anatomy>>瘘管
fireplace		[n]壁炉
stenosing tenosynovitis		[n]狭<<medical>>窄性腱鞘炎
phlebitis		[n]<<medical>>静脉炎
decathlon		[n]十项全能
manicure		[n][v]美甲
epistaxis		[n]<<medical>>鼻出血
rosin			[n]松香，树脂
tendonitis		[n]<<medical>>肌腱炎
plexus			[n]<<anatomy>>（血管、淋巴）丛
swab			
mop				
yarn			
rinse			[v]漱，冲洗
lasagna			[n]<<dietetics>><<Italian>>千层面
paronychia		[n]<<medical>>甲沟炎
fascia			[n]<<anatomy>>筋膜
creatinine		[n]<<biochemistry>>肌酸酐
anaphylactic	[a]过敏性的
bronchus		[n]<<anatomy>>支气管
acetaminophen	[n]<<biochemistry>>对乙酰氨基酚，扑热息痛
cystic fibrosis	[n]<<medical>>囊胞性纤维症
septic			[n]败血症的，腐烂的
rasp			[v]摩擦，激怒；[n]锉刀，刺耳声
constrictor		[n]<<anatomy>>括约肌，大蟒蛇
microbe			[n]微生物
germ			[n]微生物，胚胎，基础
brachial artery	[n]<<anatomy>>肱动脉
nephropathy		[n]<<medical>>肾异常
upcoming		[a]即将发生的
platy			[n]剑鱼
stool			[n]粪便
whooping cough	[n]<<medical>>百日咳
vasectomy		[n]<<medical>>输精管切除术
homeopathic		[a]顺势疗法的
homoepathy		[n]通过小剂量管理而形成的治疗体系，其中这种药物在大剂量使用时会让健康人患病
congenital		[a]先天的
paraplegia		[n]<<medical>>半身不遂
quadriplegia	[n]<<medical>>四肢麻痹
slingshot		[n]强项
tic				[n]<<medical>>抽搐，痉挛
eye orbit		[n]眼眶
thrombus		[n]<<medical>>血栓
embolus			[n]<<pathology>>栓子
hyperplasia		[n]<<medical>>增生
pedophile		[n]恋童癖者
ligament		[n]<<anatomy>>韧带
reprehensive	[a]斥责的
vascular		[a]<<medical>>血管的
angina			[n]<<medical>>心绞痛
anesthetize		[v]<<medical>>麻醉
enema			[v]<<medical>>灌肠
nebulizer		[n]喷雾器
cooling blanket	[n]<<medical>>降温毯
sigmoid			
perforate		[v]穿孔
hypoglycemia	[n]棣棠
placeta			
aspirate		
viral			
gauze			[n]纱布
ballsy			
meconium aspiration		[n]<<medical>>粪便吸入综合征
hypoxia			[n]<<medical>>缺氧
catheter		[n]导管
mimosa			
constipate		[v]
bratmurst		
atrium			
exitus			
surreal			
snoop			
abstein			
yearbook		
paramedic		[n]护理人员
neonatal		[n]新生儿科
paroxetine		
impedance		[n]阻抗
compound		
premonition		[n]<<medical>>预兆瘤
meningonia		[n]<<medical>>脑膜瘤
palliative		
ligate			
osteotomy		[n]<<medical>>截骨术
morselize		
encase			
insular			[a]孤立的，海岛的，海盗人民的
blip			[n]雷达上的物体光点
resuscitate		[v]<<medical>>使复苏，使复兴
appendectomy	[n]<<medical>>阑尾切除
alopecia		[n]<<medical>>秃顶
dementia		[n]痴呆
metastasize		[v]<<medical>>转移
ex vivo surgery	[n]<<medical>>体外手术
vagal nerve		[n]<<medical>>迷走神经
congenital tricuspid atresia		[n]<<medical>>先天性三尖瓣闭锁
uremia			[n]<<medical>>尿毒症
whiplash		[n]<<medical>>扭伤
tingly			[a]发麻
varsity			[n]大学运动代表队
paranoia		[n]<<medical>>偏执狂，妄想狂
paygrade		[n]薪饷等级
handout			[n]给乞丐的一部分食物/衣服/钱，免费发放的信息，准备好用于发放给媒体的陈述；免费给，给予
mete			[v]通过测量给出（out）；[n]界限
clarion			[n]有尖锐音调的中世纪号角；[adj]非常清晰，大声而清晰
cathartic		[n][a]<<medical>>通便药，泻药
headway			[n]进步，前进，允许通过的净空高度，同路线同方向两辆车的间隔时间
furtherance		[n]促进，推进
onrush			[n]猛冲，急流
pawn off		[v]推卸，典当
islet cell		[n]<<medical>>小岛细胞
tachycardia		[n]<<medical>>心动过速
wishbone		[n]<<medical>>叉骨，叉形杆
state-out-of-the-art		[a]顶级的
hilum			[n]种子(如豆)上标志着胚珠的附着点的疤痕，<<medical>>刀口/身体部位的缺口或开口
sternum			[n]<<medical>>胸骨
sternotomy		[n]<<medical>>胸骨切开术
pericardial		[a]<<medical>>心包的
pericardium		[n]<<medical>>心包，心包膜
locus			[n]确切地点，<<genetics>>基因座
curate			[n]助理牧师；[v]操持展出
bone up			[v]抓紧复习，刻苦读书
buttoned-up		[a]沉默寡言的，不外露的，羞怯的
staffer			[n]职员，编辑，记者
rile			[v]激怒
proprietary		[n][a]所有权，所有人
bamboozle		[v]欺骗，使迷惑
kook			[n]怪人
sour on			[v]厌恶，没有好感
hakarl			[n]冰岛干鲨
dredge			[v]疏浚，挖掘，打捞
bloodbath		[n]大屠杀
hyoid			[n][a]<<medical>>舌骨
rumple			[v]弄乱；[n]褶皱，皱纹
matrimony		[n]结婚，婚姻
polygony		[n]一夫多妻
polygamy		[n]多配偶婚姻
down payment	[n]首付
litigate		[v]提出诉讼
litigation		[n]诉讼
hatchet			[n]短柄斧；[v]用短柄斧砍，扼杀
cagey			[a]精明谨慎的，有戒心的
latency			[n]延迟，潜在因素
blastocyst		[n]囊胚，胚泡
shenanigan		[n]恶作剧，诡计
osteoid osteoma	[n]<<medical>>骨瘤
recant			[v]放弃，撤回 
aftercare		[n]<<medical>>出院后护理，出狱后安置，售后服务
painstaking		[a]艰苦的
poultice		[n]<<medical>>膏药 
comfrey			[n]<<medical>>紫草科植物
arnica			[n]<<medical>>山金车
trowel			[n]泥刀
garbology		[n]垃圾学
landfill		[n]垃圾场
sanitation		[n]环境卫生，卫生设备
zero in			[v]聚焦于一个目标
lamppost		[n]路灯柱
allegedly		[adv]据称
holy grail		[n]圣杯，圣盘
catridge		[n]小圆桶
pubescent		[a]青春期的
gingham			[n]条纹棉布
unintended		[a]非计划中的，无意识的
Saturn			[n]土星
zap				
earful			[n]唠叨
dioxin			[n]二恶英
cut corners		[v]抄近路
warts and all	[adv]毫无保留地，完全地
eyesore			[n]眼中钉
escrow			[n][v]第三方托付
slander			[v][n]诽谤，中伤 
hearken			[v]仔细听，听明白
bauxite			[n]铝土矿
pincushion		[n]针垫
qualm			[n]疑虑
mellifluous		[a]像蜜一样的
desensitize		[v]使不敏感
haven			[n]港口，避难所
maim			[v]使残废
unseemly		[a]不体面的，不得体的
shakedown		
pipeline		[n]管线，途径
time-honored	[a]历史悠久的，久负盛名的
bentgrass		[n]<<biology>>本特草
exemplary		[a]典范的，模范的
prophylactic	[n][v]预防药
beneficiary		[n]受益人
incarcerate		[v][a]监禁，禁闭
aught			[n][pron]任何东西，无价值之物[adv]任何程度上
mulch			[n]覆盖物
lobule			[n]<<medical>>肝小叶，肺小叶
fossa			[n]窝
inkling			[n]暗示，头绪，迹象
magnum opus		[n]杰作
frisk			[v]搜身，欢悦
hedonic			[a]享乐的;[n]享乐论
realtor			[n]房地产经纪人
homeowner		[n]私房房主
homeostasis		[n]<<medical>>内稳态
recrimination	[n]职责
valet			[n]贴身男仆
alligator		[n]<<biology>>短吻鳄
reprisal		[n]报复
overdue			[a]迟到的
stock			[n]血统，家畜，树干，枪柄；[v]出芽，囤货
triad			[n]三合会，三和音
mortician		[n]殡仪业者
prosthetic		[a]假肢的
imbecile		[a][n]低能人
stiletto		[n]小匕首，细高跟鞋，用于打耳洞的小工具
embroidery		[n]刺绣
atrocity		[n]凶恶，暴行 
astute			[a]狡猾的，诡计多端的
desiccant		[n][a]干燥剂
amygdala		[n]扁桃体，杏仁核
hypnotize		[v]催眠 
natter			[v]唠叨，瞎扯，抱怨 
nattering		[n]闲聊，唠叨，抱怨
lonesome		[a]寂寞的，人迹罕至的 
wedlock			[n]婚姻，已婚状态
carotid			[n]<<medical>>颈动脉
soiree			[n]晚会，社交聚会
bogeyman		[n]可怕的人 
bogey			[n]妖怪，可怕的人
alleyway		[n]胡同，小巷
insensate		[a]无感觉的，无生命的
cubicle			[n]小卧室
behoove			[v]理应，有必要
grandstand		[n]正面看台，哗众取宠的表演；[v]哗众取宠地表演
cleavage		[n]裂开，卵裂
lo and behold	你瞧
off base		[a]大错特错的
figurehead		[n]名义领袖
bookkeeper		[n]簿记员
cartel			[n]企业联盟
penthouse		[n]阁楼
high-end		[a]高端的，高档的
resurrect		[v]使复活，使恢复生气
apprise			[v]通知，告诉
housewarming	[n]乔迁庆宴
macaw			[n]<<biology>>金刚鹦鹉
extenuate		[v]减轻程度，使人原谅
extenuating		[a]情有可原的
bead			[n]珠子，念珠
tawdry			[n][a]华丽而低俗的
lettuce			[n]生菜，莴苣
nauseam			
intuit			[v]凭直觉
subsidize		[v]资助，补贴
busboy			[n]餐馆工
resourceful		[a]资源丰富的，机智的
existential		[a]存在主义的，有关存在的
myriad			[n][a]无数，种种
quandary		[n]窘境
mecca			
fussy			[a]爱挑剔的，难取悦的
stipend			[n]神职人员的薪金，助学金
nutmeg			[n]<<biology>>肉豆蔻
iceberg			[n]冰山，显露部分
jostle			[v][n]推挤，争夺 
bidder			[n]投标人，出价人
tedium			[n]沉闷，单调乏味
myristica		[n]<<biology>>肉豆蔻属
subcontract		[n][v]分包合同
soho			
stagnation		[n]停滞，萧条
cold turkey		[n]突然停止（坏习惯），突然戒毒或戒烟
quiscalus quiscula		
grackle			[n]<<biology>>白头翁
glean			[v]收集资料，拾
discourtesy		[n]无礼 
gunrunner		[n]军火走私者
druggie			[n]瘾君子
blowpipe		[n]吹风管
punter			[n]船夫，赌马者
punt			
undermanned		[a]人手不足的，船员不足的
underway		[a]正在进行中的
wallow			[v]打滚，堕落，沉迷
stockpile		[v][n]积蓄，贮存
upholstery		[n]室内装饰
foolhardy		[a]有勇无谋的，蛮干的
gimmick			[n][v]暗机关，花招
bodega			[n]酒店，酒厂
litany			[n]冗长而枯燥的陈述，连祷
carte			[n]菜单，地图
deadbolt		[n]门栓
bugle			[n][v]喇叭，军号，筋骨草属植物
teal			[n]水鸭
orchid			[n]<<biology>>兰花，兰花科植物，淡紫色
clivia			[n]<<biology>>君子兰
prerogative		[n][a]特权
dispensary		[n]药房，（学校/兵营）治疗所
frisson			[n]颤抖
prenup			[n]婚前协议
scarf			[n]围巾
plantain		[n]<<biology>>车前草
profundity		[n]深刻，深度，深奥
sartorial		[a]裁缝的，缝纫的
creeper			
refrigerant		[n][a]制冷剂
musculature		[n]<<medical>>肌肉组织
noose			[n][v]套索，束缚，绞刑
canister		[n]桶，罐
malfeasance		[n]不当行为，玩忽职守
charade			[n]打哑谜，装模做样，做戏
unbumpable		
cyanoacrylate	[n]氰丙烯酸酯
hypothermia		[n]<<medical>>低体温
lividity		[n]铅色，铁青色
decorum			[n]礼仪
solvency		[n]溶解能力，偿还能力
rink			[n]溜冰场；[v]溜冰 
coolant			[n]冷却剂
auburn			[n]赤褐色
tally			[n]计数器，记账；[v]使符合，记账 
paean			[n]赞美歌
cryostat		[n]冷却罐
wispy			[a]束状的，脆弱的 
groggy			[a]眩晕无力的
tricky			[a]棘手的，狡猾的
foyer			[n]门厅，休息室
loafer			[n]乐福鞋
momentary		[a]瞬间的
keynote			[n][v]基调，主旨
hypocrisy		[n]虚荣
decry			[v]责备，谴责
stalled			[a]失速的，止步不前的
tangle			[v][n]纠纷，乱成一团
gin				[n]杜松子酒，琴酒，三角起重机；[v]用陷阱捕捉
underwater		[a]
conducive		[a]有益的，有助的
dermatitis		[n]<<medical>>皮肤炎
untoward		[a]
mannequin		[n]人体模型，服装模特
upbringing		[n]养育 
spermatozoa		[n]精子银行
self-starting	[a]自动起动式的
forthcoming		[a]即将来临的
breadwinner		[n]养家糊口的人
subpoena		[v][n]传唤
technicality	[n]技术性细节，术语使用
almanac			[n]年鉴
vibe			[n]气氛
fandom			[n]体育迷，球迷
vig				[n]非法高利贷
hubris			[n]傲慢，自大
cheekbone		[n]颚骨 
peephole		[n]窥视孔
prankster		[n]爱开玩笑的人
straight-on		一直向前
dox				[v]人肉搜索
internecine		[a]内部的，自相残杀的
tattle			[v]闲谈，泄密
wakizashi		[n]脇差
disembowel		[v]取出内脏，开膛
duck out		[v]逃避
patsy			[n]容易受骗的人，替罪羊
big-time		[a]一流的；[n]快乐时光
cui bono		[Latin]to whose benefit
edgy			[a]锋利的，紧张的，烦躁不安的
memorabilia		[n]收藏家
discernable		[a]可辨认的
woodwork		[n]木制品
gaslight		[n]煤气灯
a literal mind	
snowbird		[n]雪鸟
arduous			[a]努力的，费力的 
gumball			[n]口香糖，警车顶灯
curry			[n]咖喱
legwork			[n]外勤
size up			[v]打量，估计
first-rate		[a][adv]一流的
coverall		[n]衣裤相连的工作服
circuitry		[n]电路
brokerage		[n]佣金，经纪费，中间人业务
embroil			[v]使卷入，使混乱 
uphold			[v]支持，鼓励，赞成
keepsake		[n]纪念品
cordgrass		[n]带状草地
intertidal		[a]潮间的
jaywalk			[v]乱穿马路
cayenne			[n]<<biology>>辣椒
quisling		[n]卖国贼
racketeer		[n]骗子；[v]敲诈
scuba			[n]水中呼吸器
prink			[v]打扮 
urology			[n]<<medical>>泌尿学
displacement	[n]取代，唯一，排水量
provenance		[n]出处，起源
screwdriver		[n]螺丝刀
loose end		[n]未完成事物的一部分
hothead			[n]鲁莽的人
garrote			[n]刑具
stoop			[v][n]弯腰，屈服，堕落 
assemblyman		[n]议员
vicious			[a]恶毒的，堕落的 
unwitting		[a]不知情的
bobbin			[n]线筒
constabulary	[n][a]警察，警官
mountainside	[n]山腰，山坡
houseguest		[n]在家过夜的客人
siphon			[n][v]虹吸管，抽取
resinous		[a]树脂的
resin			[n]树脂，松香
Levantine		[a]地中海东部的
balsam			[n]香脂
cedar			[n]雪松
cartouche		[n]漩涡装饰
postmortem		[n][a]验尸，死后的
procure			[v]获得
assuredly		[adv]确实，确信
khopesh			[n]一种埃及刀
calf			[n]小牛，腓肠
payroll			[n]工资单
potassium sulfide		[n]<<chemistry>>硫化钾
disciple		[n]门徒
peel			[v]削，剥
sumo			[n]相扑
platinum		[n]铂金
aerosol			[n][a]气溶胶，喷雾剂
face-full		
hectic			[n]脸红，患肺结核；[a]有肺结核的，紧张忙碌的，狂热的
homemade		[a]自制的，国产的
vermicompost	[n]蚯蚓粪
anthrax			[n]炭疽
on the run		在逃
compost			[n][v]堆肥
flathead		[n]美国印第安民族
cutout			[n]
sketchy			[a]粗略的
forward			[v]发送，转寄
knee-deep		[a]没膝的
platter			[n]大盘，唱片
haptics			[n]触觉论
obfuscation		[n]困惑，模糊
obfuscate		[v]使困惑
peerless		[a]无与伦比的 
strychnine		[n]<<medical>>
strait			[a]狭窄的，严格的，苦恼的；[adv]严格地；[n]海峡
kingpin			[n]中心轴，主要任务
out of contention		
meritorious		[a]有功绩的，值得称赞的
appliance		[n]器具，装置
mellow			[a][v]圆润的，柔和的，芳香醇
très			[adv]非常
deplorable		[a]悲惨的，可悲的
registrar		[n]登记员
termite			[n]<<biology>>白蚁
imperative		[a]必要的，不可避免的，祈使的
possessive		[n][a]占有欲
rigmarole		[n][a]冗长的 
layoff			[n]解雇，活动停止期间，失业期
flautist		[n]横笛演奏者
barbiturates	[n]巴比妥药物
obituary		[n][a]讣告
mundane			[a]世俗的，平凡的
purloin			[v]偷窃
remand			[v][n]送还，抵押
swelter			[n]闷热；[v]使闷热
handhold		[n]把柄
camouflage		[v]伪装
smarm			[v]奉承
promulgate		[v]公布，宣传
dotage			[n]老迷糊，溺爱 
zillion			[n][a]无限数
pique			[v]激起
prescient		[a]预知的，有先见之明的
untenable		[a]站不住脚的，不能维持的
borrachero		
scopolamine		[n]莨菪碱
stowaway		[n]偷渡者
expedite		[v]加快，促进，发出；[a]畅通的，迅速的，方便的
expedition		[n]远征，探险队，迅速
centerpiece		[n]中心装饰品
haul			[v]拖，拉
consensual		[a]双方同意的，交感的，两厢情愿的
kowtow			[v]叩头
haggard			[n]（鹰）未驯服的，野性的，憔悴的 
brigand			[n]强盗
monger			[n]商人，宣扬者；[v]兜售，散播观点
cognac			[n]法国白兰地
shingle			[n][v]墙面板，木瓦，小招牌（尤指医生或律师挂的营业招牌），鹅卵石
parch			[v]烤，烘干
baguette		[n]法国棍子面包
Camembert		[n]法国卡门贝所产的软质乳酪
straighten		[v]整顿，使好转
credence		[n]信任，凭证
jabber			[v][n]急促含糊不清地说
supposedly		[adv]按照推测，恐怕
unopened		[a]未打开的
embezzle		[v]盗用，贪污
penitentiary	[n]监狱，宗教判官；[a]监禁的
vittle			[n][v]食物，补给
storehouse		[n]仓库
reform			[v]改革，重组，改过自新，重整
pathway			[n]路，神经通路
banditry		[n]盗贼行为
russet			[a][n]黄褐色，赤褐色马铃薯
chagrin			[n][v]懊恼
sundew			[n]<<biology>>茅膏菜
provided		[conj]假如
barghest		[n]（英国民间传说中的）犬状妖怪
scourge			[n]灾祸，苦难；[v]折磨，鞭打
chaff			[n]糠，谷壳，无价值的东西；[v]开玩笑
whittle			[n]屠刀；[v]消减，切木头，弄坏身体
lop				
cameo			[n]浮雕
curtly			[adv]简略地
sunflower		[n]向日葵
cross out		[v]划线以表示某物是错的
splotchy		[a]有斑点的
seedling		[n]幼苗
heartburn		[n]胃灼热
skewer			[n]烤肉叉子；[v]刺穿 
planarian		[n]<<biology>>
at a loss		
zeitgeist		[n]时代思想，时代精神
reel			[n]可以回转的设备，如钓鱼线、电影胶卷；[v]卷起；一圈一圈转；暴力混乱地表现；摇摆或撤回（对一击的反应）；不稳定地走；[n]一种苏格兰高地的舞蹈，也可以指这种舞蹈的配乐
bisection		[n]对分
backstage		[adv]在后台
rigging			[n]索具
box cutter		[n]美工刀
dud				[n]无效的东西，失败，不合适，哑弹
duds			[n]衣服，个人物品
luminol			[n]发光氨
trashcan		[n]垃圾桶，回收站
ballerina		[n]芭蕾女演员
endeavor		[n][v]努力 
wrestle			[n][v]摔跤，搏斗
crock			[n]瓦片；[v]使虚弱，身体虚弱
instigate		[v]煽动，教唆
turnabout		[n]转变，转向
prima			[a]第一的，主要的
pulley			[n][v]滑轮
all-too-common	[a]极其常见的
verdict			[n]结论，裁定
back-to-back	[a]紧贴的
on and off		[adv]断断续续地 
gantry			[n]桶架，起重机架
paparazzo		[n]专门追逐名人的记者
monograph		[n][v]专著
confound		[v]使混乱，挫败 
padlock			[n][v]挂锁，关闭
aversion		[n]厌恶，讨厌的人 
czar			[n]沙皇，独裁者
undersecretary	[n]副长
clientele		[n]诉讼委托人
bureaucrat		[n]官僚
comer			[n]有成功迹象的人
ham-fisted		[a]笨手笨脚的
ham-handed		[a]笨手笨脚的
heavy-handed	[a]笨手笨脚的
butterfingered	[a]趋向于让东西滑落与手指的，粗心的
oust			[v]驱逐，剥夺
zoophile		[n]嗜动物癖者
ostrich			[n]<<biology>>鸵鸟
whirlwind		[n][a]旋风，忙乱 
indigent		[a]贫困的
gentrify		[v]优化，改善
dumpster		[n]大型垃圾箱，大型垃圾车
recurrent		[a]复发的，周期性的
capitalize		[v]使资本化，用大写字母，估价
plainclothes	[a][n]便衣警察
landscape		[n][v]风景，美化
epoch			[n]（地质）世，纪元
much-used		
gin martini		[n]杜松子马提尼
roofy			
amenable		[a]有责任的，顺从的
startle			[n][v]吓一跳
clutter			[n][v]杂乱 
sadism			[n]施虐狂 
presumably		[adv]大概
misogyny		[n]<<medical>>厌女症
marina			[n]码头 
micturate		[v]排尿
lease			[n][v]出租
turf			[n]草皮，泥炭，跑马场
seam			[v][n]缝合，裂开，留下疤痕
flexor			[n]<<anatomy>>屈肌
sightseeing		[n][a]观光
swimmingly		[adv]顺利地
captor			[n]捕获者
severance		[n]分离，断绝，离职补偿
wrap up			[v]包装，注意力集中于
baffle			[v]使困惑，使受挫折
scrap			[n]碎片，残余物；[v]废弃，使解体；[a]废弃的，碎的
outlier			[n]异常值，局外人
victimology		[n]受害者研究
firehouse		[n]消防站
exsanguinate	[v]使血流尽
postulate		[n][v]假定，假设
billable		[a]有利可图的
bloodletting	[n]大裁员
horchata		[n]<<dietetics>>杏仁茶
purvey			[v]供给，供应；peddle
carpet			[n]地毯
twaddle			[n][v]废话，闲聊 
declasse		[a]下等社会的
intoxication	[n]中毒，陶醉
emphysema		[n]<<medical>>肺气肿
inadvertently	[adv]无意地
proverbial		[a]谚语的，众所周知的
cognate			[n][a]同源的，同类的
fogbow			[n]雾虹
flit			
ignis fatuus	[n]鬼火，磷火
colloquial		[a]通俗的，白话文的
paraselene		[n]幻月
moon dog		[n]幻月 
parhelion		[n]幻日
sun dog			[n]幻日
emblem			[n][v]象征，纹章
hallmark		[n]表现纯粹血统的英式官方印章；令人厌恶的性格或特征
impresa			[n]写有座右铭的设备，用于16、17世纪
topper			[n]大礼帽
unaided			[a]无帮助的
auspice			[n]吉兆，赞助，主办
waistline		[n]腰围
harvest moon	[n]秋分前后的满月
gravy train		[n]轻易发大财的工作
gravy			[n]<<dietetics>>肉汁，轻易的来的钱
slump			[v]（价格，数量）骤降，重重地坐下，惨败；[n]骤降，经济不景气时期
malaria			[n]<<medical>>疟疾，瘴气
gamboge			[n]藤黄，秋天有生气的黄
carmine			[n][a]<<colour>>深红，洋红
crapulent		[a]暴饮暴食的
feculent		[a]肮脏的，不洁的
idempotent		[a]<<mathematics>>幂等的
comeback		[n]复出，翻盘
halfway house	[n]中途歇脚的客栈
beagle			[n]猎犬
overdrive		[n][v]超速，极度忙碌
pavilion		[n]亭子
finalist		[n]参加决赛的选手
wacky			[a]古怪的
sclerosis		[n]<<medical>>硬化症
lithe			[a]柔软的，易弯曲的
malaise			[n]不舒服，心神不安
bust			
mileage			[n]里程数
timetable		[n]时间表
confide			[v]吐露，委托
salient			[n]凸角；[a]显著的，突出的 
alimony			[n]赡养费
scramble		
commercial		[n]商业广告
overhear		[v]偷听
extort			[v]敲诈，勒索
peripheral		[n][a]外围的，神经末梢的
snippet			[n]一小段，一个可引用的段落，<<computer science>>代码片段
reveille		[n]起床号
goon			[n]呆子，愚笨的人
dire			[a]可怕的，悲慘的
misgiving		[n]担忧，疑虑，不安 
rationale		[n]基本原理
chapati			[n]<<dietetics>>印度薄饼
woe				[n]悲哀，灾难 
devise			[v]设计，想出，图谋；[n]遗赠
Stockholm syndrome		
bigot			[n]偏执的人
fantasia		[n]幻想曲
sunbathe		[n]日光浴
getaway			[n]逃跑
sangria			[n]<<dietetics>>
vail			
luau			[n]夏威夷式宴会
upstate			[a]北部的，偏僻的 
ivy				[n]常春藤
cataclysmic		[a]大灾变的
reassuring		[a]可靠的 
solar flare		[n]太阳耀斑
layman			[n]门外汉，外行
infrared		[n][a]红外线
mortar			[n]研钵；[v]研磨
pestle			[n]杵
dead drop		[n]秘密情报传递点
cygnus			[n]天鵝座
madhouse		[n]精神病院
variadic		[a]<<computer science>>可变参数
mantissa		[n]<<mathematics>>尾数，小数部分
devious			[a]偏僻崎岖的，不正直的
envenomation	[n]动物毒素摄入，表面变质
coagulatory		[a]引起凝结的
coagulative		[a]
taipan			[n]富商
terrarium		[n]陆地动物饲养所
sublet			[n][v]转租，房屋
oxyuranus cutellanus		
impound			[v]没收，拘留，扣押
musk			[n]麝香
skyscraper		[n]摩天大楼
rimless			[a]无边框的
bottleneck		[n]瓶颈，障碍 
discontinued	[a]停止使用的
asbestos		[n][a]石棉
logjam			[n]阻塞，僵局，停滞 
red ball		[n]特快列车
omelet			[n]<<dietetics>>煎蛋卷
wayside			[n][a]路旁
hurdle			[n]障碍，跨栏；[v]客服
solder			[n][v]焊接
rheumatology	[n]风湿病学
lifeline		[n]生命线，救生索
statute			[n]法令，法规
derby			
standoff		[n]僵局；平局
standoffish		[a]冷漠保守的
banality		[n]陈词滥调，陈腐 
riddance		[n]摆脱 
quota			[n]定额，配额
diminutive		[n][a]小的，小型的
punctilio		[n]细节，拘泥形式
impervious		[a]不能穿透的，不受影响的
whipsaw			[v]锯开
hyphenate		[n][v]连字符 
luminaria		[n]墨西哥传统圣诞灯
fulgent			[a]光辉的，灿烂的
travesty		[n][v]滑稽的模仿作品，歪曲
improvisational	[a]即兴的
wafer			[n]圆片，晶片，薄片，薄饼
goggle			[v]瞪大眼睛看；[n]护目镜，游泳镜；[a]眼睛突出的
turquoise		[n]绿宝石
enchilada		[n]<<dietetics>>（墨西哥菜）玉米卷饼，全部相关的事物
disarm			[v]缴械
disparage		[v]诽谤，贬低
retard			[n][v]延迟，阻止 
impotent		[a]虚弱无力的，阳痿的
aftershave		[n]须后水
serum			[n]血清
gadget			[n]小玩意，小工具，诡计 
sweatshop		[n]血汗工厂，剥削劳动力的工厂
diabolic		[a]残忍的，恶魔的
mitten			[n]露指手套
fixture			[n]固定设备
arity			[n]参数数量，元数
bedside			[n][a]床边，枕头边
micron			[n]微米（复数microns或micra）
thalamus		[n]<<anatomy>>丘脑
fornix			[n]穹隆
fiducial		[a]基准的，信托的
doily			[n]小布垫
crochet			[n][v]钩边
inescapable		[a]不可避免的 
pageantry		[n]壮观，华丽 
excommunicate	[v][a][n]驱逐出教会
paganism		[n]异教
clergy			[n]神职人员
tabard			[n]古代战袍
hermetic		[a]密封的，炼金术的
antiquity		[n]古物，遗物
miasma			[n]瘴气，臭气
linguine bolognese		[n]<<dietetics>>意大利扁面条
molehill		[n]鼹鼠丘，小困难，琐事
popsicle		[n]商标名（棒冰）
missus			[n]太太
tupperware		[n]特百惠（保鲜盒）
congee			[n]<<dietetics>>粥
micronize		[v]使微粉化
salivary amylase		[n]<<biology>>唾液淀粉酶
fine mist		
gassy			[a]吹牛的
gruyere			[n]<<dietetics>>瑞士干酪
drawstring		[n]细绳，拉带
micromanagement	[n]微观管理
misto ceviche	
Darth Vader		黑武士
cronut			[n]<<dietetics>>甜甜圈
wheeze			[v][n]
rotor			[n]转子
galore			[a][adv]丰富的 
atril			
laundromat		[n]自助洗衣店
nasty			[a]下流的，肮脏的，可恶的
fingertip		[n]指尖，指套
dislodge		[v]使离开原位，驱逐 
disgorge		[v]吐出，被迫交出
chauffeur		[n][v]司机，开车 
pollen			[v][n]传粉
genuine			[a]真正的，真诚的
extricate		[v]使解脱
monastery		[n]修道院 
chromatic aberration		[n]色差，像差	
draw distance	
shadow map		[n]阴影图
volumetric light		[n]体积光
ambient occlusion		[n]环境光遮蔽
depth of field	[n]视野深度
contact shadow	[n]接触阴影
light shaft		[n]采光井
factoid			[n]
writhe			[v][n]翻滚，扭动，苦恼 
small-time		[a]小规模的，不重要的
subordinate		[n][a][v]下属，服从 
symbiotic		[a]<<biology>>共生的
dismount		[n]完成
lug wrench		[n]十字扳手
workout			[n]训练，试验
hiccup			[n][v]打嗝
power grid		[n]电网
outage			[n]断电，设备暂停期
tactile			[a]触觉的
humanly			[adv]以人力地
resounding		[a]嘹亮的，彻底的
libidinal		[a]本能的，欲望的
placard			[n]海报，标牌[v]张贴，公布
rattle			[n][v]发出咯咯声，不停地说
sleep apnea		[n]<<medical>>睡眠呼吸暂停症
contusion		[n]挫伤
showdown		[n]对决
upcycle			[v]升级，改造
hematoma		[n]<<medical>>血肿
pantry			[n]餐具室，食品柜
analog			[n][a]模拟，类似
printout		[n]打印输出
wannabe			[n]想要赶超崇拜的人
scrawny			[a]瘦骨如柴的
feisty			[a]活跃的，好争吵的，易怒的
swanky			[a]炫耀的，时髦的，爱出风头的
anonymize		[v]使匿名
congregation	[n]教堂汇众
name it			
gala			[n][a]节日，庆祝
mitzvahs		
portfolio		[n]公文包，作品集
socialite		[n]社会人士
echelon			[n][v]梯形，梯队
off-the-cuff	[a]即兴的
unguarded		[a]不小心的
fundraiser		[n]捐款人
napkin			[n]餐巾纸，尿布
beanstalk		[n]
go under		破产，失败
sovereign		[n]君主，元首；[a]至高无上的，有统治权的
jasmine			[n]<<botany>>茉莉，淡黄色
bridge-burner	
lipstick		[n][v]口红，唇膏
brunette		[n][a]浅黑色肤色的女人
leche			
task force		[n]特遣部队
oddity			[n]怪癖
outstanding		[a]杰出的，显著的，未偿付的
dignitary		[n][a]高官
froggy			[a]讨厌的
on the ball		[adv]
paperclip		[n]回形针
talcum powder	[n]滑石粉
laxative		[n][a]泻药
on the fly		
rap sheet		[n]警局犯罪记录
stooge			[n][v]充当配角，密探，巡航，傀儡
unremitting		[a]不懈的，不间断的
apartheid		[n]种族隔离政策
close-up		[n]特写镜头，近距离摄景
mogul			[n]大亨
medical examiner		[n]法医
cufflink		[n]袖扣
mascara			[n]睫毛膏
calzone			[n]<<dietetics>>披萨馅饼
jangly			[a]叮当响的
paralegal		[n]律师助理
lupus			[n]狼疮，天狼座
craigslist		克雷格列表
census			[n]人口普查
extremist		[n]极端主义者
tread			
milf			
larceny			[n]盗窃，盗窃罪
larcenous		[a]犯盗窃罪的
larcenist		[n]盗窃犯
tray			[n]托盘
counterfeit		[v]造假，伪造；[n]伪造品，假药
gulag			[n]古拉格劳改营
gumdrop			[n]橡皮软糖
tipster			[n]情报贩子
surrogate dad	
on the lease	
agar			[n]琼脂
pharma			[n]制药公司
perjury			[n]伪证
feted			[n]祭祀，庆祝
misanthropy		[n]厌世
misanthrope		[n]厌世者
hyper			[a]亢奋的
handsomely		[adv]漂亮地，慷慨地
legitimize		[v]使（不合法的）合法化，赋予私生子合法地位
skyrocket		[n]流星烟火；[v]价格猛涨
antiseptic		[a][n]防腐剂
precaution		[n][v]预防 
solemnity		[n]一本正经，庄严
tradewinds		[n]信风
timeless		[a]永恒的
impotence		[n]阳痿，无力
incisor			[n]<<anatomy>>门牙
deacon			[n]执事
correctional	[a][n]教养院
toiletry		[n]化妆品
break a leg		祝你好运
veterinarian	[n]兽医
terrier			[n]小猎犬
harrowing		[a]悲惨的，痛心的
melodramatic	[a]夸张的，戏剧般的
protesquerie	
bicuspid		[n][a]尖齿，两头尖
flimper			
repertoire		[n]剧组全部节目，计算机全部指令
adjourn			[v]休会，换地方，使延期
intonation		[n]语调，音调
colloquialism	[n]白话，俗话
baggie			[n]
up to speed		了解最新情况
misadventure	[n]灾难，不幸
blindside		[v]攻其不备，出其不意，意外打击
antiestablishmentarianism		[n]反现存社会体制观念
quilt			[n]被子；[v]瞎编
militia			[n]民兵
give or take	差不多
eyelid			[n]眼皮，眼睑
holocaust		[n]大屠杀
outgrow			
debrief			[v][n]盘问，汇报情况
intersperse		[v]散布，点缀
sweep under the rug		掩盖真相
remiss			[a]疏忽的，玩忽职守的
limb thief		
eczema			[n]<<medical>>湿疹
moisturizing ointment		[n]补水膏
intrusive		[a]侵入的，打扰的
pacifier		[n]奶嘴
subculture		[n]亚文化；[v]再次培养
abound			[v]大量存在，充满
codswallop		[n]一派胡言
foggy			[a]模糊的
grisly			[a]可怕的，恐怖的
courier			[n]信使，情报员
damper			[n]阻尼器，减震器
irreparable		[a]不可修复的
whorl			[n][v]螺型纹
rut				[n][v]发情，凹槽
junction box	[n]接线盒
mole			[n]鼹鼠，堤坝，间谍
unformed		[a]未成形的，未充分发展的
scrambler		[n]电子扰频器
garble			[v]断章取义，曲解
stymie			[v]阻碍；[n]妨碍球
tête-à-tête		[n]两人私人谈话
caseload		[n]待处理案件的数量
repercussion	[n]反响，令人不满的结果
undoubtedly		[adv]毫无疑问地
intently		[adv]一心一意地
canard			[n]谬误，谣言
sloppy			[a]草率的，粗心的
ungentlemanly	[a]不具绅士风度的
Sig Sauer		
downfall		[n]垮台，覆灭
visceral		[a]内心的，发自肺腑的
undershirt		[n]汗衫
sloth			[n]懒惰，树懒
groove			[n]凹槽，惯例；[v]形成凹槽
plaque			[n]牌匾
backlog			[n][v]积压的工作
entrap			[v]下套
on the lam		在潜逃中
shoo-in			[n]常胜将军
slam dunk		扣篮
forfend			[v]防止，避开
misshapen		[a]畸形的，丑恶的
mothball		[n]樟脑球
paunch			[n]大肚子
snuff			[n]烛花；[v]剪烛花，掐灭
recuperation	[n]恢复，复原
winnow			[n]扬谷；[v]挑出来，分出好坏；用气流移除；除去不好的部分；使变窄，使减少
pare			[v]去除外边、多余或不规则的部分；通过除去部分而使减少或变小
pull it off		圆满完成
bunkum			[n]废话，空话，假话
ride out		承受得住，安全度过
genome			[n]基因组，染色体组
discretion		[n]谨慎，判断力
alarming		[a]令人担忧的
smokescreen		[n]烟幕，障眼法
cranium			[n]<<anatomy>>头盖骨
lead up to		导致，引入话题
niche			[n][v]壁龛，合适的职业
staple			[n]订书钉
eponymous		
eponym			
death blow		
peanut gallery	廉价剧场上层座位
uneventful		[a]平平常常的
buildup			[n]增强，集结
manholl			
bagel			[n]<<dietetics>>
potluck			[n]家庭聚餐
get knocked up	怀孕
recontextualize	
peacock			
crupper			
inconclusive	
implicate		
law enforcement	执法机构
quick ball		
riff			
point-blank		[a][adv]直接了断的，近距离平射的
strobe			
brand-new		[a]崭新的
monkey with		乱动，折腾
belly-up		[a]破产的，失败的
acreage			[n]面积，英亩数
white elephant	
coop up			禁闭，关起来
unwind			[v]使松弛
photogenic		
evidently		[adv]显然
unload			[v]摆脱负担
migmatite		
gneiss			
igneous			
flotsam			[n]漂浮的残骸；（移民、驱逐者）不定的人口；不重要的材料；残骸
rubble			[n]（岩石）碎片；一大堆不值钱的东西混合在一起；用于粗劣填墙或建筑的碎石；像来自采石场一样的坚硬的石头；[v]使成为碎石
pebble			[n]小圆石；透明无色石英；不整齐、破碎的表面；[v]用碎石快速连续打击；用碎石掩埋
last-minute		[a]紧急关头的
unwelt			
drywall			
taxidermist		[n]动物标本制作者
luncheonette	[n]便餐，便餐餐厅
follow suit		跟着做，学样子
crabapple		[n]海棠
seismic			[a]地震的，由地震引起的
applecart		[n]苹果贩子手推车
crony			[n]密友，亲信
surmise			[v]推测
paddy wagon		[n]囚车
specious		[a]似是而非的，华而不实的
rolodex			[n]
moot point		[n]有争议的问题
a means to an end		达到目的的手段
cease out		绝迹
fogy			[n]赶不上时代的人，老家伙
detention		[n]拘留，扣押
brio			[n]活跃，生动
remorse			[n]懊悔
treadmill		[n]跑步机
brazen			[a]厚脸无耻的
headspace		[n]
pull through	渡过难关，恢复健康
racquetball		[n]壁球
willpower		[n]意志力
keystroke		
crossroads		
ophthalmology	[n]<<medical>>眼科，眼学
jumpstart		[v]引进，安装
rotisserie		[n]<<dietetics>>
darn			
orthopedic		[a]<<medical>>整形外科的
gastroenterologist		[n]<<medical>>胃肠科医生
otolaryngologist		[n]<<medical>>耳鼻喉科医生
time of flight	[n]飞行时间
sphenopalatine ganglioneuralgia		[n]<<medical>>蝶㓵神经节神经痛
trigeminal		[n][a]<<anatomy>>三叉神经
diverticulitis	[n]<<medical>>憩室炎
reticent		[a]沉默的，不说话的
favoritism		[n]偏袒
hang in the balance		安危不定
do the math		考虑一下
on the table	公开说
breathe down one's neck		纠缠某人
lockjaw			[n]<<medical>>破伤风
insufflation	[n]<<medical>>吹入法
coalition		
create a buzz	制造话题，造势
snide			[a]伪造的，暗讽的
free solo		徒手攀登
roadblock		[n]路障
psychosis		[n]<<medical>>精神错乱
psychotic		[a][n]<<medical>>精神病的
hobble			[v][n]使跛行，蹒跚
titmouse		[n]<<biology>>山雀
on the ropes	濒临失败
credentialism	[n]履历主义
crowdsource		[v]众包
candlepin		[n]
contestant		[n]竞争者
climb the wall	坐立不安，焦躁
orwellian		[a]
catchphrase		[n]标语
Sumatra			苏门答腊岛
dunce			[n]傻瓜，笨蛋，差生
slab			[n]厚板，混凝土板
ghost town		鬼镇，废弃的城镇
at the helm		掌权
bunch of		一群
limestone		[n]石灰岩
lest			[conj]唯恐，以免
windfall		[n]意外之财
sell-propelled	[a]自推进的
sleaze			[n][v]下流的人
wildebeest		[n]<<biology>>角马（羚羊的一种）
hold water		站得住脚
grandeur		[n]庄严，宏伟
doornail		[n]门钉
as dead as doornail		死透了
brawn			[n]发达的肌肉，壮汉，助手
give sb the boot		解雇某人
occipital		[n][a]<<anatomy>>枕骨
Prussian blue	[n]普鲁士蓝
rolling pin		[n]擀面杖
get a hit on	追踪到
unregulated		[a]未经管制的
crackpot		[n][a]怪人，疯子
scull			[n][v]短桨
call the shots	发号施令，做主，操纵
up-and-coming	[a]有前途的
nonsensical		[a]无意义的
crooked			[a]扭曲的，不正当的
karate			[n]空手道
tickle			[v]觉得痒痒
probie			[n]新手，菜鸟
knitwear		[n]针织物
towelette		[n]小毛巾
meteorology		[n]气象学
tiara			[n]（罗马）女式三重冠
rain check		改天，预约之后补约
estrogen		[n]雌性激素
masculinity		[n]男子气，男性
hazmat			hazardous material
curvature		[n]弯曲，曲率
in tatters		破破烂烂
floodlight		[n]照明灯
eatery			[n]餐馆
lubricate		[v]润滑
doozy			[n]极好的东西；[a]显眼的
savant			[n][a]<<French>>科学家
calisthenics	[n]健美操
platypus		[n]<<biology>>鸭嘴兽
lothario		[n]
penny-farthing	[n]前轮比后轮大的自行车
sparring		[n]陪练，对打，保护板
Sisyphean		[a]永远做不完的
outfit			[n]机构，全套装备；[v]配给，装备
garrot			[n]止血带
excruciate		[v]折磨
kaput			[a]过时的，失效的，出故障的
loan shark		[n]放高利贷者
after-party		[n]余兴派对
autoclave		[n][v]高压灭菌器
misconception	[n]误解
serology		[n]<<medical>>血清学
sift			[v][n]筛选，详细研究
fool's errand	徒劳无功的事情，蠢事
latent			[a]潜在的，潜伏的
quaint			[a]稀奇的，离奇的
adultery		[n]通奸
miff			[v][n]恼怒，小争执
peruse			[v]精读，仔细考察
aide			[n]助手，副官
busywork		[n]相当消磨时间而又无价值的工作
papyrus			[n]纸莎草
minutia			[n](plural minutiae)小细节
stranglehold	[n]束缚，勒脖子
erotica			[n]色情作品
bullpen			[n]牛栏
prurient		[a]好色的，淫乱的
leeway			[n]余地，风压差
striation		[n]条纹，切面纹
epithelial		[a]<<biology>>上皮的
histrionic		[a]戏剧的，演员的，演戏的
clade			[n]<<biology>>进化分支
stand to reason	合乎道理
orthodoxy		[n]正统，正统观念
quay			[n]码头
paleontology	[n]<<biology>>古生物学
garden-variety	[a]普通的，平凡的
planarian		[n]<<biology>>涡虫
Genghis Khan	成吉思汗
gastroenteritis	[n]<<medical>>胃肠炎
roulette		[n]轮盘（赌博）
pipe down		安静下来
bedridden		[a]卧床不起的
pageant			[n]盛会，选美比赛
takeaway		[n]要点
precipice		[n]绝境，悬崖
pay dirt		可开采的矿石，财源
geyser			[n]间歇泉
trailblazer		[n]先驱，开路者
tenure			[n]任期；[v]授予终身职位
medical repatriation		[n]医疗遣返
obsessively		[adv]过分地
acidosis		[n]<<medical>>酸中毒
comminute		[v][a]分割，切碎
anastomosis		[n]<<medical>>吻合术
lightweight		[a][n]轻量级，无足轻重的
aortic stenosis	[n]<<medical>>动脉栓塞
fetal aortic valvuloplasty		[n]<<medical>>胎儿动脉瓣形成术
proximal femur	<<anatomy>>股骨上端
compartment syndrome		[n]<<medical>>间隙综合征
circumflex		[n]长音符号；[a]弯曲的
femoral canal	[n]<<anatomy>>股管
peroneal		[a]<<anatomy>>腓骨的
fibula			[n]<<anatomy>>腓骨
weight-bearing	[a]承重的
handpick		[v]用手挑选，精选
gestational		[a]<<medical>>妊娠期的
gestational age	[n]孕期
congenital cystic adenomatoid malformation		[n]<<medical>>先天性囊性腺瘤样畸形
hydrops			[n]<<medical>>积水
pot roast		[n]<<dietetics>>炖肉
internalize		[v]内在化（习俗，知识）
cheesesteak		[n]<<dietetics>>奶酪牛肉三明治
time-out		[n]暂停
malus			[n]<<biology>>苹果属
bradycardia		[n]<<medical>>心动过缓
gist			[n]主旨，要点
mediastinum		[n]<<anatomy>>（胸腔）纵膜
buddha			[n]佛陀，佛像
clambake		[n]（尤指以烤蛤蜊为主的）室外宴会
dogmatic		[a]教条的，武断的
pontiff			[n]罗马主教
fissile			[a]（原子，矿石）易裂开的
prognosticate	[v]预测
scumble			[v][n]使（色彩，画）柔和，用几乎干的画笔（对画）涂一层薄的透明或半透明的涂层使之变得色彩柔和
fission			[n]分裂，裂变，分裂生殖
infantile		[a]婴儿期的
infantilize		[v]使婴儿化
lenticular		[a]使用透镜的，透镜形状的
expunge			[v]摧毁，擦去，删除，标记以删除
suave			[a]柔和的，温和的
debonair		[a]高兴地，文雅的
lighthearted	[a]快乐的，无忧无虑的
obloquy			[n]谴责或辱骂，坏名声
recoil			[v][n]畏缩，弹回
retract			[v]缩回，撤销
resile			[v]返回原来的位置，弹回
gustatory		[a]与味觉有关的
aural			[a]听觉的
invective		[n][a]恶言，猛烈抨击
fissility		[n]易裂性
transducer		[n]传感器
icicle			[n]冰柱，冷冰冰的人
parvenu			[n]暴发户
nouveau riche	[n]<<French>>暴发户
plebeian		[n]平民，百姓；[a]平民的，普通的，粗俗的
codfish			[n]<<biology>>鳕鱼
codfish aristocracy		[n]暴发户
sublimate		[v]升华，将原始的冲动或欲望由不可接受的额形式变为可被社会或文化接受的
acromion		[n]<<anatomy>>肩峰
lackluster		[a]缺少光泽或生命力的
unspectacular	[a]不引人注意的，平庸的
hoodlum			[n]流氓
intercalate		[v]在日历中插入，在现存元素或图层中插入
vicarious		[a]替代的
hirsute			[a]多毛的
shudder			[v]发抖，颤栗
horripilation	[n]鸡皮疙瘩
goose bumps		[n]鸡皮疙瘩
alliteration	[n]头韵
lily-livered	[a]缺乏勇气的
glom			[v]拿，偷，抓住
weal			[n]幸福，鞭痕
convoke			[v]召集开会
vociferous		[a]大声持续叫喊的
caterwaul		[v]（猫）叫春
obstreperous	[a]发出不能维护或有攻击性的声音的，不服从控制的
squawk			[v][n]发出大声叫喊，猛烈谴责或抗议
singe			[v]烧焦
plexy			[n]发作，中风
charpy			
ingenuity		[n]心灵手巧，足智多谋
smugness		[n]洋洋自得
wax				[v]逐渐变大，月亮变满
vasa previa		[n]<<medical>>血管前置
gork			[n]植物人
teratoma		[n]<<ontology>>畸胎瘤
groundwork		[n]基础，根基，地基
chariot			[n]两轮战车
joyride			[n]乘车兜风
yap				[v]小狗乱叫
methylene		[n]亚甲基
oversee			[v]监督，无意偷看
twitch			[v][n]抽搐，猛勒
rhinestone		[n]人造钻石的一种
misconduct		[n]不当行为
soggy			[a]沉闷的，不开心的
edematous		[a]浮肿的
dreamboat		[n]梦中情人
conform			[v][a]服从环境，符合标准
conformance		[n]一致性
prepend			[v]预谋，追加（值）
intent			[a]专心的，坚决的
bourne			[n]界限，限制；目标
do-or-die		[a]非常倔强与实现自己目标的；要么成功要么失败的
manifest		[n]清单，货单；[v]清楚表明，症状显现，显灵；[a]明显的
transmogrify	[v]伴随滑稽效果的改变
metamorphose	[v]由于魔法或超自然力量而突然转变
transmute		[v]变成更高级的元素；点石成金
landmass		[n]大陆
groom			[v]梳毛，（给动物）刷洗，诱骗（以性侵），照料；[n]马夫
modulation		[n]调变
synaesthesia	[n]通感，共同感觉
falloff			[n]衰减，减退
crossfade		[n]淡入淡出
disambiguate	[v]消除歧义
relay			[n]继电器，中继设备；[v]转发
gamification	[n]游戏化，游戏机制
auteur			[n]导演
snuff film		[n]虐杀电影
medicolegal		[a][n]法医，法医学的
thereon			[adv]基于，在那上面
in the wind		在进行中
muzzle			[n]枪口，鼻口；[v]使闭嘴
projectile		[n][a]炮弹，可投掷物体
preface			[n][v]序言，引言
preputial		[a]<<medical>>包皮的
lowlife			[n]下级人
normative		[a]规范的，标准的
moonshine		[n]私酿酒
lo-fi			低保真的
derringer		[n]大口径短筒手枪
bootlegger		[n]造私酿酒的人
castor			[n]<<biology>>蓖麻，海狸，（家具）脚轮
gunpoint		[n]枪口
bartender		[n]酒保
cardroom		[n]棋牌室
ricin			[n]<<biology>>蓖麻毒素
longhand		[n]手写，书法
extrajudical	[a]未经法律许可的
penmanship		[n]书法
flagpole		[n]旗杆
thrash			[v]打，逆行
endocrinology	[n]<<medical>>内分泌学
lipodystrophy	[n]<<medical>>脂肪营养不良
scrapbook		[n]剪贴簿
malefic			[a]有害的，邪恶的
baleful			[a]致命或不好的影响；预示恶魔的
pernicious		[a]致命的，严重受伤或毁坏的
deleterious		[a]莫名或不被期望地造成伤害的
prejudical		[a]造成伤害的；导致不成熟行为的
anodyne			[a]止痛的；不会造成offend的
scone			[n]<<dietetics>>英国的一种烤饼
croissant		[n]<<dietetics>>法式羊角面包
patisserie		[n]<<dietetics>>法式糕点
azimuth			[n]方位角
infinitude		[n]无限，无穷
saturation		[n]饱和度
bummer			[n]令人失望的局面
spearhead		[n]矛头，先锋
footy			[a]愚蠢的
beeper			[n]传呼机
overreach		[v]超越；击败自己；通过精巧的方法在买卖中获得好处；（马）后蹄打前蹄；夸大
overtop			[v]到达...的顶端；超越，高于
outdistance		[n]在比赛中领先
eclipse			[v]减少...的重要程度；超越；使变暗
celestial		[a]与天堂或神有关的；与天空有关的；超凡脱俗的；[n]神秘的存在；中国人
Elysian			[a]赐福的，令人愉悦的
empyreal		[a]（地方）理想的
empyrean		[n][a]苍天；理想的地方；充满光与火的圣地
olympian		[a]好像生活在高山上一样的
supernal		[a]从天而来的；令人愉悦的；天空的
bang-up			
blue-chip		
blue-ribbon		
boffo			
bonny			
corking			
dynamite		
gangbusters		
first-string	
gilt-edged		
gone			
groovy			
high-class		
jim-dandy		
numero uno		
par excellence	
peachy			
peachy keen		
sensational		
topflight		
top-shelf		
topping			
unsurpassed		
chthonic		[a]冥界的，地狱的
plutonian		[a]冥界的，地狱的
sulfurous		[a]冥界的，地狱的
Tartarean		[a]冥界的，地狱的
Tartarus		[n]<<mythology>><<Greek>>Hades用来惩罚邪恶者的地方
Cimmerian		[a]非常灰暗或抑郁的
dreich			[a]<<Scottish>>无生机的
elegiac			[a]挽歌的，压抑的
funereal		[a]葬礼的，庄严的
godforsaken		[a]偏远的；可怜被忽视的
saturnine		[a]性情冷漠迟缓的；有讽刺态度的；抑郁的
sepulchral		[a]葬礼的
sepulchre		[n]墓碑；祭坛中举行的宗教仪式；[v]<<archaic>>埋葬
heartwarming	[a]激动人心的，令人愉悦的
outdo			[v]击败；表现更优
outgun			[v]火力压制；击败
outmatch		[v]被证明更优秀
outshine		[v]更耀眼；超越
outstrip		[v]比...更快或更远；领先于
editorial		[a]编辑的，评论的
let it slide	让它过去
waterfront		[n]水边，海滨
phallus			[n]<<anatomy>>阴茎
induction		[n]归纳，<<physics>>电磁感应
chapfallen		[a]沮丧的
urethra			[n]<<anatomy>>尿道
omentum			[n]<<anatomy>>网膜
fairway			[n]水上航道，高尔夫球球道
nordy			[a]北欧人的
underpin		[v]巩固，从下面支持，加固基础
chaplain		[n]牧师
Hall Mary		
officiate		[n]主持，行使，担任裁判
thoracotomy		[n]<<medical>>开胸术
stationery		[n]文具
glioblastoma	[n]<<medical>>恶性胶质瘤
sonnet			[n]十四行诗
splenectomy		[n]<<medical>>脾切除
laparotomy		[n]<<medical>>剖腹手术
sharpie			[n]平底帆船；狡猾的人
unwavering		[a]不动摇的
Oliver Twist	雾都孤儿
electrolyte		[n]电解液
arrhythmia		[n]<<medical>>心律失常
proactive		[a]前摄的（前一活动中的因素对后一活动造成影响的）；有前瞻性的
lanolin			[n]羊毛脂
mitral valve replacement		[n]<<medical>>二尖瓣置换术
clavicle		[n]<<anatomy>>锁骨
hydraulic		[a]水力的，液压的
bummed			[a]不高兴的，沮丧的，烦恼的
jack up			用千斤顶顶起
vasopressin		[n]<<medical>>后叶加压素
bluegill		[n]<<biology>>
nepotism		[n]裙带关系，任人唯亲
orthogonal		[a]<<mathematics>>正交的
cardigan		[n]羊毛衫
scalp			[n]头皮
wingman			[n]僚机，边锋
scuttle			[n]
scuttlebutt		[n]闲聊
latissmus dorsi	[n]<<anatomy>>背阔肌
laryngectomy	[n]<<medical>>喉头切开术
tonic			[n]补药；基音
polyline		[n]折线
ischemia		[n]<<medical>>局部贫血
stent			
sacrum			[n]<<anatomy>>荐骨
hemoglobin		[n]<<medical>>血红蛋白
jarring			[a]不和谐的，刺耳的；[n]辗轧声，冲突
bedsore			[n]褥疮
comfy			[a]舒服的
authoritative	[a]有权威的，命令式的
magnesium		[n]<<chemical>>镁
ventriculostomy	[n]<<medical>>脑室切开术
herniation		[n]<<biology>>形成疝气
amniotic fluid	[n]<<biology>>羊水
fundus			[n]<<anatomy>>底部
nonviable		[a]<<biology>>不能存活的，不能独立生存的
Easter Bunny	复活节兔子
stay in your lane		不要越线
decortication	[n]剥皮，去皮质术
peritonsillar	[a]<<medical>>扁桃体周围的
medullary sponge kidney		[n]<<medical>>海绵肾
antimetic		[a][n]<<medical>>止吐的
reinstate		[v]使恢复
mitosis			[n]<<biology>>有丝分裂
telomere		[n]<<biology>>染色体端粒
explant			[n]<<biology>>外植体
fibroblast		[n]<<biology>>纤维元细胞
apoptosis		[n]<<biology>>细胞凋亡
phagocytic cell	[n]<<biology>>吞噬细胞
protease		[n]<<biology>>蛋白酶
chromatin		[n]<<biology>>染色质
morphology		[n]词法学，形态学
homologue		[n]同系物，同源物
nematode		[n][a]<<biology>>线虫
underfoot		
expressly		[adv]清楚，明白地，特别地
hyphema			[n]<<medical>>眼睛充血
entrapment		[n]使陷入
riveted			[a]铆接的，结婚的
stapler			[n]订书机
thrombosis		[n]<<medical>>血栓
procession		[n]队伍，列队
casket			[n]棺材
stilt			[n]高跷，支撑物
deputize		[v]代理，代表
queer			[a]奇怪的，同性恋的，怪里怪气的
clickbait		[n]标题诱饵
geriatric		[n]老人，老年病人
brachial artery	[n]<<anatomy>>肱动脉
epidural		[n]<<anatomy>>硬膜上的
stalemate		[n][v]僵局，困境
mutiny			[n][v]兵变，暴乱
opacify			[v]使不透明
neigh			[n][v]（马）嘶鸣
capcake			[n]<<dietetics>>纸杯蛋糕
churn			[v][n]搅拌
intraperitoneal	[a]<<medical>>腹膜内的
tinfoil			[n]锡箔，锡纸
backbone		[n]脊柱，骨干
slink			[v]潜逃，早产
cholescystitis	[n]<<medical>>胆囊炎
turncoat		[n]变节者
lamina terminalis		[n]<<anatomy>>
commisure		
make a scene	失态
hypertrohpic	[a]<<medical>>增生的
bone spur		[n]骨刺
foraminotomy	[n]<<meidcal>>椎间孔切开术
soloist			[n]独奏者
mariachi		[n]墨西哥流浪乐队
eggnog			[n]<<dietetics>>蛋酒
hemothorax		[n]<<medical>>胸腔积血
perimenopause	[n]<<medical>>近绝经期
perimenopausal	[a]<<medical>>处于绝经期的
sideways		[a][adv]
foghorn			[n]雾角
fugue			[n]神游，一种曲调
focal			[a]焦点的，病灶的
barotrauma		[n]<<medical>>（耳）气压伤
audiometry		[n]<<medical>>听力测定
postictal		[a]<<medical>>发作后的
tibia			[n]<<medical>>胫骨
page-turner		[n]引人入胜的书
ribcage			[n]胸腔
peritonsillarabscess		[n]<<medical>>扁桃体周脓肿
distend			[v]膨胀
concession		[n]让步，特权
mainline		[v]<<medical>>静脉注射；沉溺于
paraplegic		[a]瘫痪的
beeturia		[n]<<medical>>甜菜尿
stuffy			[a]古板的，乏味的，不通气的
myxoma			[n]<<medical>>黏液瘤
unmitigated		[a]完全的，绝对的
mitigate		[v]使缓和，使减轻
snickerdoodle	[n]<<dietetics>>
hottie			[n]性感的人
myoglobin		[n]<<biology>>肌红蛋白
colic			[n]<<medical>>（婴儿）腹绞痛
colovesical fistula		[n]<<medical>>结肠膀胱瘘
peritoneum		[n]<<anatomy>>腹膜
bylaw			[n]地方规则，企业章程，次要法规
interstitial nephritis		
perky			[a]得意洋洋的，自信的，活泼的
kismet			[n]天命，命运
notary			[n]<<law>>公证人
simulacrum		[n]幻影
inaugural		[n]就职演讲；[a]开幕的，就任的
polymer			[n]<<chemical>>聚合物
polymeric		[a]<<chemical>>聚合的
polymerization	[n]<<chemical>>聚合体
perfidy			[n]背信弃义
hammock			[n]吊床
hornet			[n]大黄蜂
dirtbag			[n]邋遢的人
tarantula		[n]<<biology>>狼蛛
groin			[n]<<medical>>腹股沟
eave			[n]屋檐
tetris			[n]俄罗斯方块
tampon			[n]卫生棉条
flashy			[a]浮华的，炫耀的
bursitis		[n]<<medical>>黏液囊炎
impinge			[v]撞击，妨碍
situs inversus	[n]<<medical>>内脏反位
botox			[n]<<medical>>肉毒杆菌
hemifacial		[a]<<medical>>半面的
seroma			[n]<<medical>>血肿块
pretzel			[n]<<dietetics>>一种脆饼干
spillage		[n]溢出
chancellery		[n]大臣
fogey			[n]守旧的人
sorbet			[n]<<dietetics>>加冰的果汁
foie gras		[n]<<dietetics>><<French>>鹅肝酱
packrat			[n]（软件名）个人信息管理程序
precís			[n]<<French>>摘要，大纲
raison d'être	[n]<<French>>存在的理由
mastoid			[n]乳突；[a]乳突状的
raindrop		[n]雨滴
typhoid			[n][a]伤寒
besotted		[a]愚蠢的
debunk			[v]拆穿
mamba			[n]<<biology>>一种非洲毒蛇
pasture			[n]草地，牧场
trach			
utero			[n]子宫
turnpike		[n]高速公路收费站
tollgate		[n]收费站
boulevard		[n]大马路
transoral fundoplication		
ochre			[n]<<colour>>赭石，赭色
turmeric		[n]<<colour>>姜黄
peony			[n]<<botany>>牡丹
rebuff			[v]果断回绝，强烈批评
snub			[v]反对，通过突然一转检查，抑制，掐灭
spelunker		[n]洞穴探险者
fleck			[n]斑点，斑纹
referendum		[n]公民投票
off-putting		[a]扫兴的，令人不愉快的
skid			[n][v]打滑
lasso			[n][v]套索
strenuous		[a]狂热的，非常活跃的，勤奋的，有精力的
gamut			[n]全音节，全领域
ridicule		[v]（嘲笑）咂舌声
fusty			[a]守旧的，保守的，发霉的
viridity		[n]常绿性，草或树叶的颜色，天真无邪
highfalutin		[a]夸张的，自大的
viridis			[n]<<colour>>翠绿色
verdant			[a]<<colour>>翠绿的，没有经验的
verdancy		[n]<<colour>>翠绿，幼稚
breviary		[n]摘要，每日祈祷书
retronym		[n]返璞词
infighting		[n]暗斗，近战
despotism		[n]专制
equate			[v]等同，使相等
transvaluation	[n]重新评估
irredeemable	[a]无可救药的
dermatology		[n]皮肤科
backlash		[n]突然向后的动作或反应；对近期发生的政治或社交活动的强烈反感；钓鱼线上纠缠在一起的部分
harbinger		[n]预示将来事件的东西，预兆；先驱；[v]预言，警告...的来临
outrider		[n]骑马的参赛者；人或车的护卫队；先驱
supremacist		[n]种族主义的拥护者
airlift			[n]从其他方式不可达的空运乘客或货物的系统
vapid			[a]缺乏生机、趣味或风格，平淡的
palooka			
loopy			[a]循环的；疯狂的，奇怪的
positivity		[n]正确
craniotomy		[n]<<medical>>开颅手术
envision		[v]自己想象出一幅画面
engorge			[v]充血；狼吞虎咽
duodenum		[n]<<anatomy>>十二指肠
pontine			[a]<<medical>>脑桥的
forage			[n]放牧用的食物；寻找补给品；[v]寻找食物；掠夺；rummage
panty police	
prawn			[n]<<dietetics>>龙虾
langoustine		[n]<<dietetics>>小龙虾
crustacean		[n]<<biology>>甲壳纲
certifiable		[a]合格的；精明的，不虚假的；疯狂的
pukka			[a]真实的；上等的
sure-enough		[a]真实的，事实的
tetanus			
saltine			[n]<<dietetics>>撒盐饼干
washcloth		[n]用于洗脸和洗手的毛巾（facecloth，washrog）
amortise		[v]分期偿还；逐渐减少某资源的价值
colostomy		[n]<<medical>>结肠连接术
imperceptible	[a]非常细微的，容易被忽视的
denude			[v]剥夺很重要的东西；清除地表覆盖物以使地面裸露
wuss			[n]<<informal>>懦弱的人
periosteal elevator		
outreach		[v]超越；通过骗术优于；[n]向外够的行为；外延
salmonella		
hair ball		[n]掉毛动物舔毛而在胃中形成的头发团
grovel			[v]爬；下跪；低贱自己的身份；跌落
subservience	[n]谄媚
insufferable	[a]不可忍受的
insupportable	[a]不可忍受的；不能证实的
speedo			[n]<<British>>测速仪
speedometer		[n]测速仪，里程仪
tachometer		[n]测速仪
odometer		[n]里程仪
at rounds		
meat loaf		[n]<<dietetics>>长条烤肉
groundbreaking	[a]介绍新想法或新方法的
per se			<<Latin>>自然地
perse			[a]<<colour>>蓝灰色，类似靛色
disservice		[n]伤害，不友好或伤害性的行为
lavage			[n]<<medical>>（对器官的）冲洗
cochlea			[n]<<anatomy>>耳蜗
ode				[n]颂歌；致敬
paycheck		[n]工资
awol			[a][adv]无通知缺席
filch			[v]经常小偷小摸		
oleaginous		[a]油乎乎的；谄媚的
gushy			[a]谄媚的
hagiographic	[a]谄媚的
hagiography		[n]圣人或受尊敬的人的生平；疯狂崇拜圣人事迹
fulsome			[a]过多的；数量达的；美学、道德或一般性offensive；超过好的标准的；过分谄媚的
unctuous		[a]谄媚的
sea change		[n]一个很大的转变
ratchet			
sadist			[n]以他人受苦为乐的人
coefficient		[n]<<mathematics>>系数
audit			[n]听证会；[v]不期望正式证明地听课
palpate			[v]<<medical>>通过触觉检查
hoise			[v]举起
hoist with/by one's own petard		搬石头砸自己的脚
petard			[n]用于定向爆破的炸药；声音非常大的火药
report			[n]爆炸声
aslant			[prep][a][adv]倾斜
oblique			
off-kilter		
slantwise		
atilt			
lopsided		
listing			
kilter			
tipping			
escapade		[n]不同于传统做法的冒险行为
capriccio		
practical joke	
roguery			
shavie			[n]<<Scottish>>
interleave		
pledget			
stoned			[a]因吸毒或醉酒而精神恍惚的，极度兴奋的
cheddar			[n]<<dietetics>>英国干酪的一种
string cheese	[n]<<dietetics>>手撕奶酪
brie			[n]<<dietetics>>一种白色的柔软奶酪
subtotal		[a]（外科手术）部分的；[v]部分求和
rickets			[n]<<medical>>佝偻病
cardia			[n]<<anatomy>>胃贲门
pack rot		[n]有收集癖好的人
adenocarcinoma	[n]<<medical>>恶性腺瘤
give a crap		关心，在乎
slimy			[a]黏滑的，虚伪的
stunt			[n]手腕，噱头
lost cause		注定要失败的行动
draining		[a]非常疲惫的
rodeo			[n][v]竞技表演
on the loose	逍遥法外
on the level	老实说
cervical spine	[n]<<anatomy>>颈椎
subluxation		[n]<<medical>>半脱位
headcount		[n]总人数
aboveboard		[a][adv]正大光明地
in the long run	长远来说
shish kebab		[n]<<dietetics>>烤羊肉串
regurgitate		[v]使回流，反刍
epiglottis		[n]<<anatomy>>会厌软骨
gonorrhea		[n]淋病
dysphasia		[n]<<medical>>言语障碍症
hemorrhoid		[n]<<medical>>痔疮
hideout			[n]藏匿处
take sth under advisement		对某事加以考虑
mucosal			[a]<<medical>>粘膜的
Braille			[n]布莱叶盲文
obstetrics		[n]<<medical>>产科学
grapefruit		[n]<<dietetics>>西柚
preeclampsia	[n]<<medical>>惊厥前期
igloo			[n]爱斯基摩人的冰屋
tundra			[n]苔原，冻原
pedigree		[n]血统
silver lining	一线希望
stipple			[n][v]点画，点刻
make a dent in	削弱，取得有效进展
prostate		[n]<<anatomy>>前列腺
testosterone	[n]<<biology>>睾丸酮
hunker			[v]蹲下，盘坐
thaw			[v]融化，解冻，使变暖和；[n]关系缓和，解冻时期
thaw out		解冻
straitjacket	[n]紧身衣
excitable		[a]易激动的，易怒的
probity			[n]正直
bootless		[a]无用的，无利可图的，无益处的
prune			[v]删除，减少，修剪；[n]<<colour>>深紫红色，傻瓜
quick-witted	[a]机制灵敏的
dissemble		[v]掩饰，假装
proscribe		[v]剥夺权利，禁止
catatonia		[n]<<medical>>肌肉紧张症
indisposed		[a]不舒服的，不合适的
milkshake		[n]奶昔
urinal			[n]尿壶，小便器
daredevil		[n][a]铤而走险的人
upbeat			[n]乐观的，积极向上的
sarcoma			[n]<<medical>>肉瘤
dyskinesia		[n]<<medical>>运动障碍
unreasonable	[a]不可理喻的
warpath			[n]敌对情绪
tamponade		[n]<<medical>>心包填塞
indefatigable	[a]不知疲倦的
untapped		[a]塞子未开的，未使用的
tingle			[n][v]刺痛
prophylaxis		[n]<<medical>>
sourpuss		[n]讨人厌的人
pulmonale		[a]<<medical>>肺的
ectopic			[a]<<medical>>异位的
casserole		[n]一种食物的容器
derriere		[n]臀部
herpes			[n]
neanderthal		[n]像野人一样的人
poufy			
mistletoe		[n]<<botany>>(Visucum album of the family Loranthaceae, the mistletoe family)
ramekin			[n]<<dietetics>>用于准备做奶酪的用模具或贝壳烘焙的面包渣或鸡蛋
wildflower		[n]野花
caroler			[n]唱圣歌的人
rainmaker		[n]通过人工方式求雨的人
spearmint		[n]<<botany>>(Mentha spicata)一个用于调味的常见薄荷
omental			[a]<<medical>>网膜的
moyamoya		[n]<<medical>>烟雾病
craniofacial	[a]<<medical>>有关头盖骨和脸部的
parietal		[a]有关墙的一部分或洞的
touch and go	快速的行动，一触即发的形势
confetti		[n]（婚礼、狂欢节用的）五彩纸屑
pella			[n]斗篷
detritus		[n]碎石，岩屑
brooding		[a]沉思的
rejoice			[v]使高兴
rejoice in		拥有
sustenance		[n]食物，营养；扶持生活的东西
pabulum			[n]食物，精神食粮，陈腐无味的东西（演讲，文章）
vivisection		[n]<<medical>>活体解剖
no-strings-attached		
lisa francesa	[n]<<biology>>北梭鱼
tenpounder		[n]<<biology>>北梭鱼
bonefish		[n]<<biology>>北梭鱼
ladyfish		[n]<<biology>>北梭鱼；海鲢
metatarsal		[a]<<biology>>有关人类脚或四足动物后蹄的
tarsus			[n]<<anatomy>>踝骨
phalange		[n]<<anatomy>>指骨，趾骨
shortcake		[n]<dietetics>脆而未加糖的饼干
escargot		[n]用作食物的蛇
humet			[n]
fess			[v]供人，坦白
xiphoid			[n][a]剑状，剑突
umbilicus		[n]<<medical>>脐
meltdown		[n]崩溃，灾难，彻底垮台
flexure			[n]弯曲程度；转，扭断
temporoparietal	[a]<<medical>>颞顶的
preterm labor	[n]早产儿生育
spin out		
medulloblastoma	[n]<<medical>>神经管细胞瘤
musicophilia	
gridlock		[n][v]（交通要道）完全堵住		
joyous			[a]高兴的
preconceive		[v]根据已有知识或经验形成一个看法
scapula			[n]<<anatomy>>肩胛骨
levant			[v]<<British>>逃债
urbi et orbi	[Latin]to the city (Rome) and the world; to everyone
cilantro		[n]<<dietetics>>用于调味的香菜叶
blue cheese		[n]有蓝绿色霉的奶酪
dry-erase		
footwear		[n]用于脚部的特别装备
cramp			[v]压扁；[a]难以看懂的；狭窄的
hibachi			[n]<<Japenese>>木炭火盆
brazier			[n]火盆
neutrophil		[n]<<biology>>嗜中性粒细胞
aquamarine		[n]绿色或蓝色的绿宝石；发绿色的蓝色
beryl			[n]绿宝石
semiprecious	[a]半宝石的，次珍贵的
sandbag			[n]沙袋；[v]不公平或严厉地对待；用粗鲁的手段胁迫；掩藏真实意愿以获取优势
clammy			[a]软、黏、湿的；缺乏人情的
hotwire			[v]短路点火
upside			[n]（价格）上升趋势；好的方面；潜力
uveal melanoma	[n]<<medical>>葡萄膜黑色素瘤
unravel			[v]解混乱通过分离线拆散；解开某物的谜团或复杂度
plunder			[v]掠夺；错误地大量使用
poppycock		[n]无意义的话；空话或空文章
barege			[n]
lithography		[n]用光滑石板或金属板打印，其中图案吸墨而空地反墨
snipe hunt		
carat			
instrumental	
humdrum			[a]单调无聊的
stodgy			[a]单调无聊的
Phoridae		
windbag			[n]特别能说的人
conversationalist		[n]特别能说的人
gasbag			[n]特别能说的人
motormouth		[n]特别能说的人
blabbermouth	[n]特别能说的人
sainthood		[n]圣人性质
fornication		[n]婚外性行为
fille de joie	
paunchy			[a]肚子大的人
potbelly		[n]大肚皮
compact			
flagrante delicto		[n]做坏事；正处于性行为的状态
stultify		[v]使迟钝，使停顿；使无效；使不合逻辑
steganography	[n]在一个文件、图片或信息中隐藏另一个的方法或研究
folklore		[n]民间传说；研究民间传说的学问；没有科学证据但广为流传的概念或故事
haptic			[a]触觉的
exorbitant		[a]不在法律范围内的；越过合适界限的
spatula			[n]平薄的工具，用于调和或涂抹；压舌板
frankincense	[n]乳香
glycyrrhizin	[n]甘草酸
allegation		[n]指控
forfeiture		[n]（财产）没收；（权利、名誉）丧失
mongoose		[n](pl. mongeese)猫鼬
thuggish		[a]暴力的；野蛮的
foreclose		[v]排除...的可能；提前解决；解决一个分期付款
smoothbore		[n]无膛线炮
globtrotter		
backgammon		[n]双陆棋
disseminate		[v]宣布，散布
bespectacled	[a]戴眼镜的
delicatessen	[n]准备好的食物；熟食店
defenestration	[n]将人或东西扔出窗户；从政治场的敏捷的撤出
overture		[n]提议；序言；音乐剧的歌剧序言
prescription	[n]眼睛度数
doppel			
look-alike		[n]看起来像别的东西的东西
intravenous		[a]<<anatomy>>静脉内的
backslap		[v]过分展示善意
ripe for		
inadmissible	[a]不可错过的
rover			[n]海盗；射箭术里一个所及或长距离的目标；流浪者；没有固定位置的队员；用于探索外太空地面的物体（月球车）
lichen			[n]地衣；苔藓
tangential		[a]<<mathematics>>正切的；离题的
befall			[v]像命运注定一样发生
hops			[n]啤酒花
slush			[n]半化的；[n]烂泥，污水；胡说八道；[v]溅湿；灌砂浆；上润滑油
hotcake			[n]烤饼
like hotcakes	快速
sciacchetra		[n]酒杯
epiphany		[n]灵感
braise			[v]炖
agita			[n]紧张或焦虑的感觉
jumpsuit		[n]连身裤
playbook		[n]书形势的游戏规则，常用技巧或方法的集合
parishioner		[n]教区居民			
uncanny valley	[n]恐怖谷理论
run-of-the-mill	[a]普通的
très chill		[a]非常冷
godsend			[n]天赐之物
unenforceable	[a]不可执行的
cannibal		[n]<<biology>>食同类尸体的
mulberry		[n](Morus of the family Moraceae)桑，黑紫色
libation		[n]作为祭品倒酒的动作，庆祝性地喝酒，含酒精的饮料
mixologist		[n]酒吧调酒员
blackout		[n]停电，擦除，压制，雷达信号的短暂失联，分割一场戏的短暂关灯
rousing			[a]令人振奋的
intake			[n][v]摄入
blepharoplasty	[n]<<medical>>眼睑整容术
rhinoplasty		[n]<<medical>>鼻整形术
squeaky			[a]咯咯响的
avocation		[n]业余爱好
omission		[n]未完成或被否定的事情，省略的动作或状态
appraiser		[n]评估师
transpire		[v]发生，发展；发出气态物质
bitumen			[n]沥青
seepage			[n]泄露，泄露量
uninspired		[a]缺乏灵感或源头的
ouster			[n]驱逐，罢黜，剥夺
radicalise		[v]使极端化
skimmer			[n]回收车
draconian		[a]严厉的
gelatinize		[v]使成凝胶状，涂凝胶
foreseeable		[a]可预知的
flak			[n]高射火炮，抨击
coiling			[n]螺旋，成卷
propane			[n]<<chemical>>丙烷
bandwidth		[n]带宽，能考虑某事的精神上的能力
wayward			[a]不受管理的，难以预料的，事与愿违的
consulate		[n]领事，领事馆，领事任期
colonoscopy		[n]<<medical>>结肠镜检查
chacuterie		[n]猪肉熟食店
unindicted		[a]未被指控的
mindset			[n]感情倾向，精神状态
watershed		[n]流域，分水岭，（用在名词前）转折点
loofah			[n]<<biology>>丝瓜，用丝瓜做的搓澡巾
dopamine		[n]<<biochemistry>>多巴胺
suitor			[n]求婚者；请愿者；起诉人
misrepresented	[a]不如实陈述的
zilch			[n][a]零
bric-a-brac		[n]有装饰或情感价值的常见小东西的收集
naturopath		[n]自然疗法（不适用药物和手术）
gracilis		
osseointegrated	[v]<<medical>>骨结合
wiry			[a]柔韧的；（声音）像金属丝振动的；强壮有力的
sinewy			[a]强壮的，硬的
sinew			[n]腱；力量，主要支持力量
mainstay		[n]支柱
foremast		[n]前桅
beeline			[n]直线；[v]走直线去
kiosk			[n]亭（卖报纸摊等用的地方），提供服务信息的小终端，公用凉亭
gazebo			[n]有顶、四面敞开的凉亭
belvedere		[n]欣赏风景用的凉亭
cupola			[n]圆形拱顶（通常置于圆形底座上的圆形拱顶，构成屋顶或天花板）；建在屋顶上的小建筑；用于在铸造厂熔化铁的圆筒形熔炉；火车车位车顶上凸起的观察哨站
cylindrical		[a]圆柱形的
tuyere			[n]股风口
caboose			[n]船上的厨房，供火车乘务员用的安装在后面的火车车厢，尾随者，臀部
harlequin		[n]丑角；纹理额杂色图案
variegated		[a]杂色的；富于变化的
manhole			[n]用于让人进入地下或封闭结构的孔
blowtorch		[n]吹管（燃烧器一种小型燃烧器，具有通过空气或氧气的喷射来加强燃烧的装置，通常包括一个由手动泵加压的燃料箱，尤用于管道）
newswire		[n]新闻专线
wire service	[n]新闻专线
unfiltered		[a]为过滤的
tip-top			[a][n]一流的，非常好的
hypodemic		[a]皮下注射的
sicilian		[a][n]西西里的
reliance		[n]信赖，相信的人或物
bewilder		[v]使迷惑，使不知所措
metalworker		[n]金属加工工人
pantomime		[n][v]手势；哑剧
mime			[n]哑剧
bullwhip		[n]生牛皮长鞭
mortifying		[a]引起强烈羞耻或尴尬的
garrote			[n]绞刑，绞刑用具
photojournalist	[n]新闻摄影记者
astronomical	[n]天文学的，数量巨大的
summons			[n][v]传票
marquess		[n]侯爵
earl			[n]伯爵
marchioness		[n]侯爵夫人
conjugal		[a]结婚的，夫妻间的
racehorse		[n]比赛用马
studly			[a]有男子气概的
interchangeable	[a]可互换的
ante			[n]赌注
rant about		大吼，斥责
moderator		[n]仲裁人，解调人；减速剂
corndog			[n]<<dietetics>>玉米热狗
aglow			[a]发红的，暖色调的，容光焕发的
levy			[n][v]征收，征兵，征税
vignette		[n]装饰图案；短的叙述性的文学摘要；短暂的一幕（电影中）；[v]简要描述
stiffen			[v]使僵硬
head-on			[a]正面的，迎头的
whimsical		[a]古怪的
insurmountable	[a]不能克服的
catharsis		[n]泻
conflux			[n]汇流，聚合点
sweatbox		[n]禁闭室
unsavory		[a]难吃的
lowball			[v][n]虚报低价
inscrutable		[a]神秘的，难懂的
vernacular		[n]方言；[a]本地的，地方的
matriculation	[n]入学考试
foreskin		[n]<<anatomy>>包皮
homestead		[n]宅地，房屋
rascal			[n][a]流氓，无赖
bismuth			[n]<<chemical>>铋
suss out		[v]弄明白，调查以获取更多知识
widdle			[n][v]小便
freeloader		[n]不速之客，吃白饭的人
nifty			[n]俏皮话；[a]俏皮的
sashimi			[n]<<dietetics>>生鱼片
carpe diem		<<Latin>>及时行乐
mandu			[n]<<dietetics>>韩国饺子
merry-go-round	[n]旋转木马
kitsch			[n][a]低俗作品
kitschy			[a]（艺术）肤浅的
cellultitis		[n]<<medical>>蜂窝组织炎
sieve			[n]筛，滤网
picante			[n]<<dietetics>>放在taco上的沙司
speakeasy		[n]非法经营的酒吧
paperwork		[n]文书工作
ingress			[n]入口，入境
boardroom		[n]会议室
namely			[adv]换句话说，即
subconscious	[a][n]潜意识的，下意识的
recollection	[n]回忆，回想起来的事物
indocumentado	[n][a]非法入境的（墨西哥人）
undergird		[v]加固
windshield		[n]挡风玻璃
writing on the wall		[n]不祥之兆
proprietor		[n]业主，经营者，所有人
ricochet		[v]弹开
middling		[n][a]中等的，中间的
posit			[v]假设，断言
reparation		[n]赔偿，修理，赔款，罚球
pretermit		[v]省略，无视，中断
borderline		[n][a]边界；[adv]差不多
shorthand		[n][a]速记，速记法
indecipherable	[a]无法辨认的
letdown			[n]失望，败笔，松弛，松懈，飞机的下降过程
pissant			[n]<<vulgar>>不重要的人
squamata		[n]<<biology>>（脊椎）有鳞目
wriggly			[a]蠕动的，蜿蜒的，回避的
dreadnaught		[n]无畏的人
disheartening	[a]令人沮丧的
dysfunctional	[n]<<medical>>机能失调的，有障碍的
house red		[n]招牌红酒
pinot grigio	[n]<<dietetics>>灰皮诺（葡萄酒名）
chardonnay		[n]<<dietetics>>一种无甜味白色葡萄酒
soufflé			[n]<<dietetics>>蛋奶酥，<<medical>>杂音
chasm			[n]峡谷，裂口
vasodilation	[n]<<medical>>血管扩张
peninsula		[n]半岛
trying time		[n]艰难的时间
gazelle			
perdition		[n]毁灭，地狱
hit the fan		陷入困境
suntan			[n]晒黑，棕色
arondissement	[n]法国的行政区
Lothario		[n]色狼
Oxyuranuss cutellatus		
scallion		[n]<<dietetics>>葱
monzonite		[n]二长岩
Boreal Snaketail		
aside			[prep]在旁边；[n]旁边，悄悄话
cockroach		[n]蟑螂
exfoliate		[v]片状脱落
pegged			[a]钉住的
futuristic		[a]未来派的，未来主义的
saurian			[n][a]<<biology>>蜥蜴
warmonger		[n]好战者
moulder			[v]腐朽，腐烂；[n]制模工
pheromone		[n]<<biology>>（昆虫）信息素
primate			[n]<<biology>>灵长类动物
gnocchi			[n]<<dietetics>>用土豆和面疙瘩做的团子
undeterred		[a]未受阻的
serrated		[a]<<biology>>有锯齿的，锯齿状的
conniption		[n]歇斯底里
cistern			[n]水箱，蓄水池
poopster		[n]流行艺术画家
delist			[v]从单子上划去，删除，摘牌			
yardarm			[n]either end of the yard of a square-rigged ship
derring-do		[n]大胆的行为
rappel			[v][n]绳降
Scandinavian	[n][a]斯堪的纳维亚人，北欧日耳曼语系
consternation	[n]惊愕，惊慌失措
sacrophage		[n]食肉动物
cinnabar		[n]朱砂
receptacle		[n]花托，容器，插座
llama			[n]<<biology>>美洲羊驼
chanfron		[n]保护马头前部的盔甲
ossuary			[n]骨灰盒
conquistador	[n]西班牙征服者
Persian			[n][a]波斯人，波斯语
Mycenae			[n]迈锡尼
diesel			[n]柴油，柴油机；[a]
kerosene		[n]煤油
alkaline		[a]碱性的
fluoride		[n]氟化物
fluorosis		[n]氟中毒
monovalent		[a]<<chemistry>>一价的；<<biology>>仅能抵抗一种细菌的
turbidity		[n]浑浊度
piranha			[n]（巴西）水虎鱼
exodus			[n]大批离去
cordially		[adv]诚挚地
derrick			[n]起重机
sacrilegious	[a]亵渎神明的
Creole			[n][a]克里奥尔人，克里奥尔式法语
Mesoamerica		[n]中美洲
molosser		[n]<<biology>>藏獒的一种
syncretic		[a]合一的，融合的
syncretism		[n]汇合，（宗教的）合并
morion			[n]无面甲的头盔，石英
visor			[n]面甲，遮挡眼睛的帽子，一种固定在汽车挡风玻璃顶部的可移动的平遮阳伞，伪装
quartz			[n]石英（一种由二氧化硅组成的矿物，以无色透明或彩色六角形晶体或晶体团形式出现）
Caucasoid		[a]白种人的
effigy			[n]雕像，肖像
quipus			[n]古秘鲁人的结绳文字
mizen			[n]后桅的纵帆
mast			[n]桅杆
ensorcell		[v]迷惑
rosary			[n]玫瑰经，念珠
reputedly		[adv]据说，一般认为
flintlock		[n]燧石枪
copal			[n]<<biology>>
inlaid			[a]嵌入的
filigree		[n]金银丝；[v][a]用金银丝装饰
stormwater		[n]暴雨水
well-toned		
stonewall		[v][n]拖延，障碍
worldview		[n]世界观
jurisprudence	[n]法律体系
jurisprudent	[n]法律学家；[a]熟悉法律的
firmware		[n]固件
paisley			[n][a]漩涡花纹图案
futon			[n]日式床垫
paranormal		[a]超常的，超自然的
gullibility		[n]易受骗
conical			[a]圆锥形的
proselytize		[v]使改变宗教信仰
transference	[n]转移，转让，调任
closed-minded	[a]思想保守的
mendacious		[a]虚假的，说谎的
overt			[a]明显的，蓄意的，公开的（犯罪）
al dente		[a]筋道的
enquire			[v]询问，调查
taut			[v]使纠缠；[a]拉紧的，紧张的，整洁的
cinchona		[n]<<biology>>
bowstring		[n]（用三根麻线制成的）弓弦
admittedly		[adv]诚然，公认
stele			[n]石碑，石柱
critter			[n]生物，动物，怪物，...样的人
Guinea			[n]几内亚
milquetoast		[n]胆小鬼
progressivism	[n]进步主义
panoply			[n]全套盔甲
revamp			[v]修改，修订，翻新
formidable		[a]强大的，可怕的
thievery		[n]偷窃
ametrine		[n]紫黄色水晶
yonder			[adv]在那边；[pron]那边
window dressing	[n]粉饰
prognostication	[n]预测，预兆
brickyard		[n]砖厂
foreshock		[n]地震的前震
crucifix		[n]十字架
foxhole			[n]战壕
amicable		[a]友好的
attestation		[n]证实
aggrandize		[v]夸大，增强
fine-tooth		
wheelman		[n]驾驶员
helmsman		[n]驾驶员
underling		[n]下属，部下
guesstimate		[v][n]没有充足信息的推测
expletive		[n]咒骂语，虚词，填补物；[a]附加的
vulgarism		[n]下流话
profanity		[n]亵渎，亵渎的话
profane			[a]亵渎的；[v]
taboo			[a]由于道德或品味而禁止的，由于危险而禁止的；[v][n]禁忌
four-letter word		[n]由四个词组成的骂人的话
cadre			[n]骨干
foothill		[n]丘陵
happenstance	[n]意外事件，机遇，巧合
onesie			[n]连体衣
roadhouse		[n]客栈
sidestep		[v]回避，横跨一步
sui generis		[a]独特的
anthropomorphize		[v]使人格化
culotte			[n]短裙
divided skirt	[n]裙裤
thiosulfate		[n]<<chemistry>>硫代硫酸盐
tarnation		[n]诅咒
germane			[a]相关且合适的
skulk			[v]潜伏，躲藏，逃避责任；[n]
plaid			[n]格子花呢，格子图案
tartan			[n]苏格兰格子呢绒
hoard			[v]存储，积存；[n]存储，存储物，情报库
vinyl			[n]乙烯基，黑胶唱片
plumbum			[n]铅
dingle			[n]幽谷，峡谷；[v]发出叮当声
downbeat		[n]（乐谱）强拍，下拍；[a]令人沮丧的，悲观的
mouselike		[a]胆小如鼠的
frittata		[n]<<dietetics>>意大利式菜肉馅煎蛋饼
riptide			[n]洪流
wyrm			[n]（欧洲的）龙
peon			[n]苦工
moccassin		
lapel			[n]翻领
chicken out		临阵退缩
checkered		[a]多变的
peccary			[n]野猪类
appreciable		[a]可观的，大量的
rundown			[n]
conjecture		[n][v]推测，臆测
switchblade		[n]弹簧刀
bicarbonate		[n]重碳酸盐（HCO3）
expectoration	[n]痰，咳痰
sacbe			
exemption		[n]豁免
issuance		[n]<<American English>>发布，发行
heedless		[a]不理智的，考虑不周到的
insider trading	
malapropism		[n]有幽默感的不小心的词语误用
diminution		[n]减少
depletion		[n]减少
shrinkage		[n]减少
step-down		[n]减少
contact tracing	[n]接触者追踪
invidious		[a]引人厌恶的，有害的，嫉妒的
jaundiced		[a]患有黄疸的，有偏见或恶意的
write off		[v][n]从文件中删除
vilipend		[v]不重视，蔑视
contemn			[v]蔑视
ignominious		[a]可耻的，下流的
supercilious	[a]目空一切的
trash-talk		[n][v]用于对手间恐吓对方的嘲讽或夸耀的话
play down		
acclaim			[v]称赞，喝彩
bellybutton		[n]<<anatomy>>肚脐
anxiety attack	[n]焦虑发作
refulgence		[n]发光的状态或属性
lambent			[a]发光的，闪光的
resplendent		[a]发光的，辉煌的
pelagic			[a]与海洋有关的
maritime		[a]与海洋有关的
decoupage		[n]剪纸
recap			[v]扼要重述
recapitulate	[v]扼要重述，重新定义
boil down		[v]归结
epitomize		[v]概括
synopsize		[v]概括
crenellated		[a]有锯齿的，锯齿形的
parapet			[n]护栏，矮城墙女儿墙
watchtower		[n]观察塔
fractious		[a]易怒的，倔强的
unruly			[a]无纪律的，不受管理的
diaphanous		[a]透明的，虚幻的，不真实的
cobwebby		[a]薄的
gauzelike		[a]薄的
gossamer		[n]不切实际的；[n]蛛网，不切实际的东西
see-through		[a]透明的
fatuous			[a]愚蠢的
complacent		[a]自满的
complaisant		[a]顺从的，讨好的
unconcerned		[a]漠不关心的，无忧无虑的
insouciant		[a]漠不关心的，无忧无虑的
pococurante		[a][n]冷漠的
risible			[a]可笑的，引人笑的
by-blow			[n]私生子
chancroid		[n]<<medical>>[性病]软下疳
granuloma inguinale		[n]<<medical>>
leprosy			[n]<<medical>>麻风病
mycobacterium	[n]<<biology>>分支杆菌属
Mycobacterium leprae		[n]<<biology>>麻风杆菌
lymphogranuloma venereum		[n]<<medical>>淋巴肉芽肿
Chlamydia trachomatis		[n]<<biology>>沙眼衣原体
Chlamydiaceae	[n]<<biology>>衣原体科
tuberculosis	[n]<<medical>>肺结核
unsworn			[a]<<law>>未宣誓的
foregoing		[a]前文给出的，发生过的，提及过的
supreme			[a]最高等级的，最终的
consular		[a]与领事有关的
legislature		[n]立法机构
apportion		[v]分配，分摊
sanctity		[n]忠诚，神圣，不可侵犯性
undercut		[v]廉价出售，打擦边球
superlative		[a]最高的，最高程度的
bodacious		[a]了不起的，性感的，明显的
outright		[a]全部的，直率的；[adv]当场，立即，全部
voluptuous		[a]丰满性感的，风骚的，奢华的，非常享受的
sensual			[a]肉体的，感官的，性感的
sensuous		[a]肉体的，感官的，性感的
carnal			[a]肉体的，性的，临时的
nut-job			[n]笨蛋
arresting		[a]引人注意的
emphatic		[a]着重的，显著的
decided			[a]不容置疑的
pronounced		[a]强烈标记的，不容置疑的
prescriptive	[a]规定的，规范的；[n]规范性
bonhomous		[a]友善的
bonhomie		[n]善意
meretricious	[a]有妓女性质的，谄媚的，肤浅的
plaintive		[a]表达痛苦的，悲伤的
rueful			[a]悲伤的
lamentable		[a]悲伤的，抱怨的
lugubrious		[a]悲伤的，凄凉的
plangent		[a]声音巨大刺耳的，凄切的
impecunious		[a]长期身无分文的
stentorian		[a]非常响亮的
earsplitting	[a]声音巨大且不舒服的
tonsorial		[a]与理发有关的
dernier cri		[n]最新款式，时尚
craze			[n]疯狂；[v]使疯狂，产生裂纹
fad				[n]时尚，狂热
hot ticket		[n]非常流行的人或事物
blouson			[n]夹克衫
couture			[n]缝纫，缝纫衣服
Valium			[n]<<medical>>安定
diffident		[a]缺乏自信的，羞怯的
pertinacious	[a]固执的
melodious		[a]好听的
execrable		[a]非常坏的，令人讨厌的
execrate		[v]诅咒，厌恶
anachronistic	[a]纪年错误的
lissome			[a]柔软的，敏捷的
coif			[n]头巾，金属防护帽
coiffed			[a]整理过发型的
polymathic		[a]博学的
polymath		[n]博学的人
vestige			[n]遗迹，退化的器官
vulpine			[a]狐狸的，狡猾的
palmy			[a]繁荣的
palm			[n]棕榈，胜利的标志，胜利
Palmae			[n]<<biology>>棕榈科
Arecaceae		[n]<<biology>>棕榈科
coquette		[n]向男人卖弄风情的女人
hummingbird		[n]蜂鸟
Trochilidae		[n]<<biology>>蜂鸟科
Apodiformes		[n]<<biology>>雨燕目
passerine		[a]<<biology>>雀形目
negligible		[a]可以忽略的
pithy			[a]有骨髓的，（证据、观点）有力的
terse			[a]简洁的，打磨的
laconic			[a]过分简洁的（显得粗鲁或神秘）
monosyllabic	[a]只使用多音节词的，（回答或评论）非常简洁的
sententious		[a]富于使用格言的，简洁的，说教的
homiletic		[a]布道的，陈词滥调
sermonic		[a]说教的
thumbnail		[n]拇指大小的摄像头；[a]简洁的
circuitous		[a]不直接的，语言或行动复杂的，圆形的
circumlocutory	[a]不简洁的
roundabout		[a]不直接的，绕圈的；[n]迂回的路，旋转木马
prolix			[a]非常长的，啰嗦的
rambling		[a]冗长的
officious		[a]自愿提供服务的，不正式的，非官方的，爱管闲事的
meddle			[v]管闲事，干预
meddlesome		[a]倾向于干预的，爱管闲事的
cogent			[a]有说服力的，相关的，有亲和力的
puerile			[a]年轻的，小孩子的
jejune			[a]年轻的；缺乏品味的
implacable		[a]难以缓和的
inimical		[a]敌对的，有恶意的
inhospitable	[a]敌对的，（环境）不提供遮蔽的
garrulous		[a]长篇大论的
prosy			[a]（谈话、讲演）平庸的
loquacity		[n]多嘴，饶舌
loquacious		[a]多嘴的
outmaneuver		[v]以计谋取胜于
outslick		[v]通过诡计获取优势
outfox			[v]以计谋取胜
quintessential	[a]非常典型的
macho			[a]过分刚硬的；[n]
machismo		[n]显示男人骄傲的，夸大表现力量的
virile			[a]有男子气概的
streetwise		[a]拥有在危险环境生存技能的
hunkiness		[n]
hunky			[a]（男性）性感迷人的
contrarian		[n]在股票中买别人卖的股票的人
exigent			[a]需要紧急帮助或行动的，需求高的
clamant			[a]吵闹的，紧急的
clamorous		[a]喧闹的，坚持而令人讨厌的
necessitous		[a]贫困的，紧急的
luster			[n][v]光泽
wasabi			[n]芥末酱，山葵
rhizome			[n]<<biology>>块茎
Wasabia japonica		[n]<<biology>>
Eutrema wasabi	[n]<<biology>>
commute			[v]改变，交换，降低（惩罚强度），补偿，经常往返于，满足交换律；[n]
truancy			[n]逃学行为，逃学状态
truant			[a][n]逃学的
out of one's hair		不再打扰某人
morass			[n]沼泽，阻碍
aleatory		[a]基于运气的，与不幸有关的
aleatoric		[a]被不确定因素决定的
elucidate		[v]阐释
cometfruit		[n]<<dietetics>>
rambutan		[n]<<dietetics>>
pitahaya		[n]（或 pitaya）<<dietetics>>火龙果
Selenicereus	
Hylocereus		
Sternocereus	
Tunnock's teacake		[n]<<dietetics>>
gyokuro			[n]<<dietetics>>（日本）玉露差
daifuku			[n]<<dietetics>>大福
panforte		[n]<<dietetics>>用无花果和杏仁做成的硬面包
bazin			[n]<<dietetics>>
challah			[n]<<dietetics>>犹太人在安息节吃的用鸡蛋发酵的面包
naan			[n]<<dietetics>>印度次大陆的圆而平的发酵面包
Gruyère			[n]<<dietetics>>（瑞典）有坚果味的坚硬奶酪
Gouda			[n]<<dietetics>>一种源自荷兰的脂肪含量更高的温和奶酪
Edam			[n]<<dietetics>>荷兰产的一种黄色的压制干酪，通常做成扁平的球状，外面涂有红色的蜡
Stilton			[n]<<dietetics>>一种蓝纹奶酪，外皮起皱，由加了奶油的全脂牛奶制成
feta			[n]<<dietetics>>用羊奶或山羊奶制成的一种中等硬度、易碎的白色希腊干酪，在盐水中腌制
pomelo			[n]<<dietetics>>
pomegranate		[n]<<dietetics>>
lingonberry		[n]<<dietetics>>
culantro		[n]<<dietetics>>
salsify			[n]<<dietetics>>
chervil			[n]<<dietetics>>
borage			[n]<<dietetics>>
papaya			[n]<<dietetics>>
honeydew melon	[n]<<dietetics>>
persimmon		[n]<<dietetics>>
quince			[n]<<dietetics>>
civet			[n]<<dietetics>>
affogato		[n]<<dietetics>>
café bombon		[n]<<dietetics>>
guillermo		
musselcrusher	[n]<<biology>>主教鸟
biskop			[n]<<biology>>主教鸟（非洲南部两种大型散生海生食用和运动鱼类）
stennbras		[n]<<biology>>主教鸟
fer-de-lance	[n]<<biology>>矛头蛇
rye				[n]<<dietetics>>黑麦
sourdough		[n]<<dietetics>>酵母
leaven			[n][v]酵母，催化因素
shiitake		\shē-ˈtä-kē\[n]<<biology>>椎茸（香菇一种深色的亚洲香菇(蘑菇科香菇属)，因其可食用的黄褐色到棕色的帽子而广泛种植于山毛榉科的树林中）
chanterelle		[n]<<biology>>鸡油菌(一种芳香的可食用蘑菇(香菇属)，通常有黄色到橙色)
cremini			[n]<<biology>>一种栽培的褐色或褐色肉质蘑菇，与更大更成熟的鲍托贝洛菇属相同
chayote			\chī-ˈyō-tē\[n]<<biology>>佛手瓜
kumquat			\ˈkəm-ˌkwät\[n]金橘（<<biology>>一种小的黄色到橙色的柑橘类水果，有甜的海绵状的果皮和有点酸的果肉，主要用于蜜饯）
disenchant		[v]使醒悟
accoutrement	[n]装备，（常用复数）不包括衣服和武器的其他士兵装备，表面且有代表性的特征或装备
tristate		[a]三角洲地区的，三态的
sommelier		[n]侍酒师
sally			[v]突围，嘲讽预言，不常规的远足；[v]出发，突破
quip			[n]嘲讽性回复，模棱两可的话，奇怪的东西；[v]取笑
quiddity		[n]本质，怪癖
somersault		[n]翻筋斗
Salientia		
preposterous	[a]荒谬的，不合常态的
kabuki			[n]歌舞伎（由日本男性表演的传统剧种）
galvanize		[v]镀锌，通电，刺激
ginseng			[n]西洋参
umwelt			[n]客观世界
revile			[v]咒骂，斥责
incest			[n]乱伦
reimburse		[v]偿还，赔偿
indemnify		[v]赔偿，保护
monetize		[v]使成为合法货币，赚钱
monetization	
ave atque vale	[Latin]hail and farewell
sodomize		[v]鸡奸
sodomy			[n]同行肛交或口交，兽交
sherbet			[n]<<dietetics>>稀释或软化的冷饮
gelatin			[n]明胶，动物胶
minaret			[n]（伊斯兰教）尖塔
macramé			[n]打成几何图案的粗糙的花边
portion			[n]嫁妆，命运；[v]分配，给嫁妆
allot			[v]分配（资源)
neoteric		[a]现代的
solitudinarian	[a]隐士
anchorite		[n]（由于宗教原因）隐士
anchoress		[n]女隐士
introvertish	[a]有些内向的
solivagant		[a]独自徘徊的
noctivagant		[a]夜晚漫游的
autophobia		[n]对孤独的病态恐惧
eremite			[n]隐士，（由于宗教原因）隐士
bruazino		[n]<<dietetics>>(Italian)
convection		[n]对流
pareve			[n]（食物）不含肉或奶的
redoubtable		[a]令人生畏的广受尊重的
nonplus			[n]迷惑的状态；[v]使不知所措
captious		[a]挑事的，蓄意设计而使困惑的
hypercritical	[a]非常挑毛病的
censorious		[a]严厉斥责的
fastidious		[a]非常挑剔的，需求非常高的，需要特别营养的
bibulous		[a]吸附性很强的，喜欢喝酒
bedraggled		[a]被泥泞拖累的，残败的
awash			[a]被水打湿的
funambulist		[n]走钢丝，精神灵敏的展示
sanitary		[a]卫生的，清洁的；[n]公共厕所
turpitude		[n]下流，卑鄙行为
chivy			[v]追赶，使烦恼
pester			[v]纠缠，使烦恼
loon			[n]疯子，潜鸟
solecism		[n]不合语法的词语罗列，说话中的小错误，小错误，小失礼
disingenuous	[a]密谋的，有不诚实表象的
roundtable		[n]大会
pandiculation	[n]起床后的肢体伸展
permutation		[n]系统的大升级，（数学）置换
emulsion		[n]乳状液体，悬浊液
pleonasm		[n]冗余
zaftig			[a]（女人）丰满的
dumbfound		[v]短暂地震惊，使不知所措
diphthong		[n]双元音
crepitus		[n]<<medical>>捻发音
crepitate		[v]发出尖锐、重复、突然的响声
crackle			[v]发出尖锐、重复、突然的响声，冒泡，发疯；[n]
intracardiac	[a]<<medical>>心脏内的
backhand		[n]向左倾斜的字迹，（网球，篮球）反手一击
fellatio		[n]口交
parenchymal		[a]<<biology>>实质组织的
foul play		[n]不正当行为，犯规
infarction		[n]<<medical>>梗塞
cowcatcher		[n]排障器（用于排除铁轨上障碍物的火车头钱的车架）
gape			[v]裂开，打哈气，张大嘴
oscitancy		[n]打哈气或抻懒腰的动作，困倦，迟钝
oscitant		[a]困得打哈气的
circumambulate	[v]环行
deambulation	[n]散布，走
noctambulist	[n]梦游者
somnambulist	[n]梦游者
suspiration		[n]长叹，大喘气
manducation		[n]圣餐仪式中接受圣礼的部分，咀嚼的动作
mastication		[n]咀嚼
masticate		[v]咀嚼，用嚼的方式使变成浆状
deglutition		[n]吞咽
glutton			[n]贪吃的人
borborygmus		[n]<borborygmi>由移动气体导致的内脏蠕动
onomatopoeia	\ä-nə-ˌmä-tə-ˈpē-ə\[n]拟声词
oeillade		[n]眼睛一撇，抛媚眼
singultus		[n]<~es>打嗝
ingurgitate		[v]狼吞虎咽
mesentery		[n]<<anatomy>>肠系膜
mesenteric		[a]<<anatomy>>肠系膜的
sternutation	[n]打喷嚏
emesis			[n]呕吐
technicolour	[n]彩色印片法
eructation		[n]打嗝，打饱嗝
Ascaris lumbricoides		[n]<<medical>>蛔虫
megrim			[n]偏头痛，眩晕，低沉
osculate		[v]吻
cavalier		[n]骑士，绅士，女士的舞伴或陪护；[a]漫不经心的，有气质的，外交的
quacksalver		[n]骗子，庸医
unsalvageable	[a]不能挽救的
flashback		[n]退回到一个不希望的位置，文学作品中由插入后面发生的事件而形成的时间顺序叙事的破坏
chronological	[a]按事件顺序的
long-drawn-out	[a]冗长的，持续时间长的
shaggy-dog		[a]与一个长久的偶然性发生的故事有关的，其中这个故事是基于一些不相关事件的，它让讲话者感到很有意思却对观众来说无聊且无意义
doggerel		[a]风格松散、尺度不规则的（为了滑稽或喜剧效果），以琐碎或低劣为特征的；[n]这样的诗篇
inferiority		[n]低劣，平庸
abaxial			[a]远轴的，离轴的
hacksaw			[n]弓形锯，钢锯
cable			[n]电缆，海底电报，缆绳
nether			[a]低的，位于低处的
ooid			[n]鲕状石
per capita		<<Latin>>每人
confabulate		[v]不正式地交谈，谈话，用想象填补记忆空白
rheumatoid arthritis		[n]<<medical>>类风湿性关节炎
lupus erythematosus		[n]<<medical>>红斑狼疮
hydroxychloroquine		[n]<<biochemistry>>羟化氯喹
hock			[n]抵押，典当，肘关节
infodemic		[n]关于一个问题的突然性信息爆发
trolley			[n]手推车，有轨电车
trolley problem	[n]电车难题（一个疯子把五个无辜的人绑在电车轨道上。一辆失控的电车朝他们驶来，并且片刻后就要碾压到他们。你可以拉一个拉杆，让电车开到另一条轨道上，但是另一个电车轨道上也绑了一个人）
utilitarianism	[n]功利主义（最好的结果是最多数人的最好结果）
deontologicalism		[n]道义主义（行为的好坏取决于本身而不取决于结果）
aphasia			[n]失语症
embolism		[n]<<medical>>栓塞
plogging		[n]在跑步时捡起垃圾的行为
portmanteau		[n]大旅行箱，合成词；[a]多用途的
morpheme		[n]词素
timorous		[a]胆小的
perquisite		[n]特权，额外补贴
loutish			[a]粗野的，无礼的
discrete		[a]离散的，不连续的
xeriscape		[n]节水型园艺
proctology		[n]<<medical>>直肠病学
capsaicin		[n]辣椒素
downrange		[a][adv]
albatross		[n]<<biology>>信天翁，沉重的负担，阻碍
irreverence		[n]不尊重
cannabinoid		[n]大麻素
hyperemesis		[n]<<medical>>强烈的呕吐
homonym			[n]同音异义词
homonymous		[a]有歧义的，同音异义词的
isomer			[n]<<chemistry>>同分异构体
isomeric		[a]<<chemistry>>同分异构的
consortium		[n]联盟，合伙
downtrend		[n]（经济）下降趋势
longueur		[n]<<plural>>冗长乏味的章节
eotmidate		[n]<<biochemistry>>依托咪酯
powerball		[n]（彩票）强力球
back-alley		[a]卑劣的，鬼鬼祟祟的，用危险不合法的方式偷偷做的
empirical		[a]经验主义的
jarhead			[n]锅盖头（对美国海军陆战队士兵的称呼）
batternut squash		[n]南瓜
tailspin		[n]旋尾降落，混乱
lowdown			[n]真相，内幕
canoodle		[v]爱抚，亲热
diapason		[n]声音的一次爆发，全音域，音叉，范围
tuning fork		[n]音叉
refulgent		[a]辉煌的，灿烂的
concordance		[n]调和，一致，（书中引用的）索引
conchology		[n]贝壳学
footlocker		[n]军用小提箱
par for the course		[a]经常发生的，不足为奇的
pursuant		[a][adv]依照
pinsetter		[n]（保龄球）摆放球的人
curveball		[n]曲线球
stiction		[n]克服物体间摩擦力使之运动的最小力
limbic			[a]<<biology>>边缘的
choke hold		掐脖子
gumshoe			[n]侦探；[v]从事侦探工作
windsurfing		[n]帆板运动
modicum			[n]一点点
stakeout		[n]监视
primordial		[a]原始的，最初的
wetnap			
wimp			[n]懦弱的人；[v]退缩
heat prostration		中暑
aioli			[n]<<dietetics>>蒜泥蛋黄酱
attitudinize	[v]装腔作势
philander		[v]与许多人做爱，（男人）对配偶不忠
step out		短时间内离开某个地方，有用力的步伐走货行军，死亡，不忠（on），社交活动频繁
literary		[a]书面的
no quarter		[literary]（对敌人、对手）不留情面
propensity		[n]倾向，习性
protestation	[n]主张，断言，抗议
mastodon		[n]乳齿象，庞然大物
ruination		[n]毁灭
rendition		[n]render的状态或结果
moratorium		[n]由权威宣布的合法拖延，拖延
gest			[n]冒险故事，诗歌中的浪漫，冒险
midget			[n]（通常做表语），（动物）比一般要小的东西，（贬义）非常小的人
peewee			[n]很小的小孩，年轻人的运动，非常小的东西
runt			[n]非常小的动物，（贬义）非常矮的人
mesomorphic		[a]身体强壮的
mesomorph		[n]身体强壮（适合当运动员）的人
carabiner		[n]登山用的铁锁
pecan			[n]山核桃
cockamamie		[a]可笑的，荒谬的，微不足道的
hinky			[a]值得注意的
snooty			[a]傲慢的
voyeurism		[n]窥阴癖者
suprasternal	[a]<<anatomy>>胸骨上的
manubrium		[n]<<anatomy>>（胸骨）柄
isthmus			[n]峡
leapfrog		[v][n]蛙跳，一个人从另一个人背上跳过去的游戏
misstep			[v][n]过失
wacko			[n][a]怪人
whizzer			[n]离心干燥机
cowl			[n]蒙头斗篷
turnout			[n]参加一个活动的人数，岔路，清理，装备，穿着，产量
getup			[n]穿着样式
rig				[n]装备，服装
pylon			[n]巨大的通道，桥塔，交通指示塔
pundit			[n]博学的人，批评家
pandit			[n]（称号）（印度）博学的人
whodunit		[n]侦探故事，谜一样的故事
replica			[n]复制品
memorandum		[n]备忘录（复数memoranda）
caboodle		[n]堆，伙
kennel			[n]狗屋，一群狗，排水沟；[v]安置于狗窝中
Dalmatian		[n]达尔玛西亚狗
countertop		[n]面板，工作台
rave			[v]咆哮，极力夸奖，胡言乱语，参加狂欢
bellwether		[n]牧羊人，领头人
divagate		[v]离题，流浪
j'accuse		[n]指控
centerfold		[n]杂志的裸体照片插页
commisary		[n]杂货店，食堂，军粮供应
alterward		
jet lag			[n]时间差
broccoli		[n]<<vegetable>>西兰花
cauliflower		[n]菜花
agaric			[n]木耳
ergonomic		[a]人体工程学的
chicory			[n]<<vegetable>>菊苣
solstice		[n]至日，至点
anarchy			[a]无政府状态，混乱
Britannica		[n]大英百科全书
stridor			[n]<<medical>>尖锐刺耳声
footwell		[n]（驾驶员）脚踩的地方
talk turkey		打开天窗说亮话，讨论重点，开门见山
nother			[a]another
bruxism			[n]<<medical>>磨牙症
menstrual		[n]<<medical>>月经的
mononucleosis	[n]<<medical>>单核细胞增多症
tonsillectomy	[n]<<medical>>扁桃腺切除术
diphtheria		[n]<<medical>>白喉
prednisone		
immunization	[n]免疫
divertimento	[n]<<Italian>>
tapioca			
booth			
croquet			
stalwart		[n]忠实的拥护者；[a]忠实的，强壮的，勤奋的
conflate		[v]粘到一起，使混乱，把（两段文字）放到一起
floss			[n]牙线
namaste			[n]（起源于印度，用于瑜伽课）合十礼
cantankerous	[a]脾气不好的，难相处的
hard-pressed	[a]被紧紧追赶的，任务紧张繁忙的
embitter		[v]使怨恨，使痛苦
flatfoot		[n]警察，有常规轨迹的巡警
instep			[n]脚背
spaniel			[n]西班牙猎犬
dyslexia		[n]难语症
remoulade		[n]<<dietetics>>蛋黄酱
fusobacterium necrophorum		[n]<<medical>>坏死梭杆菌
parapharyngal	
sclera			[n]<<anatomy>>巩膜
vasculitis		[n]<<medical>>血管炎
eosinophil		[a][n]<<medical>>嗜曙红细胞的
cretinisim		[n]<<medical>>白痴症
lacrosse		[n]<<sports>>长曲棍球
curling			[n]<<sports>>
gaelic football	[n]<<sports>>
hare and hounds	[n]<<sports>>
ice hockey		[n]<<sports>>
jiu jitsu		[n]<<sports>>
korfball		[n]<<sports>>
kendo			[n]<<sports>>
kickboxing		[n]<<sports>>
muay			[n]<<sports>>
netball			[n]<<sports>>
polo			[n]<<sports>>
rugby			[n]<<sports>>
shinty			[n]<<sports>>
taekwondo		[n]<<sports>>
triathlon		[n]<<sports>>
frisbee			[n]<<sports>>
stork			
hypothyroidism	[n]甲状腺机能减退
glib			[a]油嘴滑舌的
below the belt	不公正地
low blow		[n]一次无原则或不道德的进攻
bare-kunckle	[a]不使用拳击手套的，残暴凶狠的
strubbly		[a]（头发）不整齐的
gaumy			[a]粘的，不整洁的，笨手笨脚的
streel			[n]懒散不整洁的人
slommacky		[a]特别不整洁的，乱七八糟的
Hurrah's nest	[n]不整齐的一堆，一堆挡路的残骸
hurrah			[n][v]欢呼，喝彩，激动
uxorious		[a]溺爱妻子的
empleomania		[n]当官瘾
pot-valiant		[a]酒后壮胆的
deipnosophist	[n]餐桌上健谈的人
table talk		[n]（有关明星的）闲谈
opsimath		[n]年老学习的人
cachinnate		[v]（拟声词）大声笑
mundivagant		[a]流浪于世界的
myelitis		[n]<<medical>>脊椎炎
legalese		[n]法律术语
gallium			[n]<<chemistry>>镓
hypovolemic		[a]<<medical>>
angiography		[n]<<medical>>血管造影
snippy			[a]暴躁的
hemolytic anemia		[n]<<medical>>溶血性贫血
sarcoidosis		[n]<<medical>>结节病
nodule			[n]瘤，结
exudate			[n]<<medical>>渗出物
turducken		[n]肚子塞有肚子塞有鸡的鸭子的火鸡
easy as pie		非常容易
shambolic		[a]非常混乱的
cytoxan			[n]<<medical>>环磷酰胺
protean			[a]变形虫的，千变万化的
nipcheese		[n]<<archaic>>吝啬鬼
muckworm		[n]<<archaic>>吝啬鬼
dryfist			[n]<<archaic>>吝啬鬼
lickpenny		[n]<<archaic>>消耗大量钱的东西
bittern			[n]<<chemical>>盐卤，<<biology>>
amaroidal		[a]苦的，与苦味有关的
schlep			[v]to proceed or move especially slowly, tediously, awkwardly, or carelessly
kibitz			
squib			
sprat			[n]鲱属小海鱼，瘦小个子
flummadiddle	
flapdoodle		[n]胡话
folderol		[n]胡话
livery			[n]制服，侍从
formosity		
venust			
lachrymose		[a]爱哭的
ashram			[n]修院
begrutten		[a]哭哭啼啼的
fustilugs		
clodhopper		[n]乡巴佬
stumblebum		[n]笨手笨脚的人，无能的人
bumblepuppy		
nineholes		
bumble			[v]结结巴巴地说话，犯错误
curmudgeon		
ettercap		
crosspatch		
ankyroid		
dogheaded		[a]
cassideous		
lacrimiform		[a]
chiropractor	[n]<<medical>>脊椎按摩师
suppository		[n]<<medical>>栓塞剂
acupuncturist	[n]针灸师
asphyxiaphyliac	[a][n]窒息癖
aporia			
embarassment	[n]<<medical>>呼吸困难
thespian		[n][a]悲剧的，悲剧演员
tendinitis		[n]<<medical>>腱炎
patellar		[a]<<medical>>膝盖骨的
louche			[a]名声不好的，不本分的
adenoma			[n]<<medical>>腺瘤
cataplexy		[n]<<medical>>猝倒（不能移动或说话但仍有感觉）
methadone		[n]<<medical>>一种用于治疗海洛因成瘾的药物
mitochondrion	[n]<pl. ~dria>线粒体
farrago			[n]混乱的混合物
skipper			[n]船长，队长
spate			[n]洪水，一大波，一次强壮有力的爆发
freshet			[n]洪水
thorium			[n]<<chemistry>>钍
lithium			[n]<<chemistry>>锂
lucid			[a]明澈的，头脑清晰的
constructive	[a]有建设意义的，有帮助的
aphelion		[n]远日点
deracinate		[v]灭绝，根除
ministerial		[a]部长的，内阁的
lido			[n]公共露天游泳池
planchet		[n]造币用的金属板
vernal			[a]与春天有关的
estival			[a]与夏天有关的
hiemal			[a]与冬天有关的
brumal			[a]冬天的，荒凉的
torpor			[n]迟钝，不关心，迟钝
languor			[n]身体或精神的虚弱，无精打采
parasol			[n]轻量级的雨伞
brolly			[n]<<British>>雨伞
bumbershoot		[n]<<American>>雨伞
oversummer		[vi]在夏天生存
chiaroscuro		[n]（画）明暗对比法
psittacosis		[n]<<medical>>鹦鹉热
tenebrism		[n]暗色调主义
polonium		[n]<<chemical>>钋
courvoisier		[n]一种葡萄酒品牌
tabernacle		[v]暂时居住；[n]帐篷，神龛
ginormous		[a]巨大无比的
prequel			[n]前传
Bushido			[n]武士道
bulimia			[n]<<medical>>贪食症
ataxia			[n]<<medical>>运动失调
drumstick		[n]鸡腿，鼓槌
schistocyte		[n]<<medical>>裂细胞
connote			[v]意味，暗示
iniquitous		[a]邪恶的，不公正的
impious			[a]不虔诚的，不孝的
brainiac		[n]非常聪明的人
blockhead		[n]笨蛋
dumbbell		[n]笨蛋
fathead			[n]笨蛋
hammerhead		[n]笨蛋
numskull		[n]笨蛋
kuncklehead		[n]笨蛋
pinhead			[n]笨蛋
string bean		[n]青豆
ottoman			[n]无扶手或靠背的凳子
Thrombotic Thrombocytopenic Purpura		[n]<<medical>>血栓性血小板减少性紫癜
eyebrow			[n]眉毛
birdshot		[n]鸟弹
promiscuous		[a]有多个性伴侣的，难以分类的，不寻常的，随便的
emetic			[n][a]催吐药
bedpost			[n]床柱
pleural effusion		[n]<<medical>>胸腔积水
coliseum		[n]竞技场，大体育场
doppelganger	
hyperhidrosis	[n]<<medical>>多汗症
cliffhanger		[n]悬念
pyrexia			[n]<<medical>>发烧
gypsum			[n]石膏
annulment		[n]取消，废除，失效
epipheseal		[n]<<medical>>
cirrhosis		[n]<<medical>>肝硬化
cataract		[n]<<medical>>白内障
tularemia		[n]<<medical>>兔热病
Legionnaire's Disease		[n]<<medical>>军团菌
carbuncle		[n]
handful			[n]一手拿得下的量，一个小数量，很难对付的东西
buzzkill		[n]<<American>>扫兴的东西或人
autonomic nervous system dysfunction		[n]<<medical>>自主神经功能紊乱
syncope			[n]<<medical>>晕厥
vasovagal syncope		[n]<<medical>>血管迷走神经晕厥
mope			[v][n]忧郁，感到无聊
gig				[n]短期工作，（with）当音乐家，为速度设计的船，旋转的东西，穿着奇怪的人，抓鱼用的长矛，军事弱点；[v]
rowboat			[n]划艇
Pythagorean's theory		[n]<<math>>勾股定理
humoral			[a]<<medical>>与激素有关的；过敏反应的
cutaneous		[a]<<medical>>与皮肤有关或影响皮肤的
colourectal adenocarcinoma		[n]<<medical>>结肠腺癌
oversell		[v]卖很多东西；吹嘘
hypochondria	[n]<<medical>>过度担心个人健康以至于幻想出一些病症
phenobarb		[n]<<medical>>包含phenobarbital的药片
phenobarbital	[n]<<medical>>一种巴比妥盐，用作催眠药、镇定剂和抗惊厥药
convulsant		[n]<<medical>>惊厥
glutethimide	
metallosis		
teriyaki		
polka dot		
siamese			
putty			
liftoff			
licorice		[n]甘草
dysosmia		[n]<<medical>>嗅觉失常
kulich			
tunnel vision	[n]<<medical>>管状视野
western equne encephalitis		[n]<<medical>>
plasmacytoma	[n]<<medical>>浆细胞瘤
clozapine		[n]<<medical>>氯氟平
ganglionic		[n]<<medical>>神经节的
phytanic acid	[n]<<medical>>植烷酸
nueralgia		[n]<<medical>>神经痛
gregarious		[a]群居的，善于社交的
seaworthy		[a]经得起航海的
poultry			[n]家禽，家禽肉
plosive			[n][a]<<linguistics>>爆破音
fricative		[n][a]<<linguistics>>摩擦音
approximant		[n]<<linguistics>>无擦通音，近似式
labial			[n][a]<<linguistics>>唇音
palatal			[n][a]<<linguistics>>上颚音
alveolar		[n][a]<<linguistics>>齿龈音
velar			[n][a]<<linguistics>>软腭音
uvular			[n][a]<<linguistics>>小舌音
liaison			[n]<<linguistics>>连音
per diem		按天，每天
itinerary		
reversal		[n]逆转，（法律）撤销
volte-face		[n]政治逆转
about-face		[n]逆转，向后转
home stretch	冲刺阶段
jink			[v]（在闪避过程中）快速改变方向
endgame			[n]最后阶段，残局，尾声
grand finale	[n]压轴戏
sapphic			[n][a]古希腊诗人沙弗风格的，与女同性恋有关的
trochaic		[n][a]扬抑格诗句
perfunctory		[a]敷衍的，凑合的
propofol		[n]<<medical>>异丙酚
photon			[n]<<physics>>光子
inculcate		[v]反复灌输
repetition		[n]重复
bespoke			[a]定制的
extravert		[a]外向的
anhedonia		[n]
randy			[n]悍妇；[a]冲动的，鲁莽放肆的
copacetic		[a]极好的
butler			[n]男管家
dander			[n]皮毛、羽毛或头发等的碎片，可成为过敏原；脾气，生气
dandruff		[n]鱼鳞或其他地方的死亡白色表皮细胞，也指这种东西非常多而且向外发散的状态，并且通常很痒
sandman			[n]睡魔
gorgon			[n]蛇发女妖
creme de squid	[n]<<dietetics>>鱿鱼甜酒
rhapsodize		[v]作狂想曲，把...描述为狂想曲
deanery			[n]<<British>>学院院长职位，乡间牧师管辖的辖区
deus ex machina	[n]意外介入而扭转局面的人
delink			[v]去除连接
topiary			[n][a]灌木修剪
calve			[n]小腿
osmosis			[n]<<physics>>渗透，渗透作用
risque			[a]下流的，淫秽的
misnomer		[n]用词不当，名字用错
mesmerize		[v]催眠
mesmerism		[n]催眠术
spellbind		[v]用法术迷惑
kraken			[n]挪威传说中的北海巨妖
speleology		[n]洞穴学
off-colour		[a]不整齐的，颜色不标准的，模棱两可的，近乎下流的
bassinet		[n]摇篮，摇篮车
dormer			[n]老虎窗
angulous		[a]有角的
procrastination	[n]拖延
troposphere		[n]对流层
profess			[v]宣誓效忠，向某人表达信念，用语言认领，当教授
pejorative		[a]有负面评论的，下流的
laudatory		[a]与赞扬有关的，表达赞扬的
stardom			[n]明星界
behavioral		[a]行为的
tilapia			[n]<<biology>>罗非鱼
squalor			[n]肮脏，低劣
bladder			[n]囊状物，膀胱
homo sapiens	[n]智人
ghoulish		[a]令人毛骨悚然的
bougainvillea	[n]<<botany>>叶子花属，是温带地区常见的装饰性植物，包括有荆棘的灌木、藤蔓和树木，属于石竹目紫茉莉科
inflorescence	[n]<<botany>>花序
staminate		[n]<<botany>>有雄蕊的，雄性的
sepal			[n]<<botany>>花萼
window box		[n]窗台上用于装一些土种植植物的盒子
windowsill		[n]窗台
heliconia		[n]<<botany>>
meunière		[a]<<dietetics>>涂面粉后用奶油煎成的
postpartum		[n]<<medical>>产后抑郁症
squeamish		[a]容易呕吐的，在行为或信仰上过分挑剔的，容易感到被冒犯的
goofball		[n]傻瓜，巴比妥酸盐安眠药
goofy			[a]疯狂，滑稽可笑的，傻的
fluster			[v][n]慌张
mongrel			[n][a]杂种，混血
mongrelize		[v]使杂交，使混血
rife			[a]充足的，随处可见的；大量存在的（with）；到处都是且越来越多的
tempura			[n]<<dietetics>>放在面糊或油里炸的蔬菜或海鲜
preparatory		[n][a]预科
contingency		[n]偶然发生的事件，应急措施
underserved		[a]服务不周到的
mien			[n]风度，风采；穿着
misconstrue		[v]误解，曲解
astigmatism		[n]<<ophthalmology>>散光
breadroll		[n]面包卷
schnapps		
epistemology	[n]认知论
mimeograph		[n]一种用模版印刷的复制机
veterinary		[a]兽医学的
grubstake		[v]给予某人物质援助以开公司或在困难时期给予帮助
Grub Street		[n]穷困潦倒的文学家的世界或这一种类的人
layup			[n]上篮
lay up			存起来，因疾病或受伤而不能参赛，不再提供服务
purebred		[n][a]纯种动物
enormity		[n]巨大
expurgate		[v]删去，抽减
penurious		[a]吝啬的，缺乏的，贫穷的
snorkel			[n]通气管，呼吸管；[v]用通气管潜水
pore over		仔细阅读
tone down		缓和，降低
social-climbing	[a]攀高枝的
gainfully		[adv]有收入地
midriff			[n]人体躯干的中间部分，膈，女士盖住膈的衣服
midsection		[n]
bootleg			[n]船的上半部分，私酿酒，未经批准的音频或视频；[v]违法携带、生产或运输，走私
mountain dew	[n]私酿酒
white lightning	[n]私酿酒
quarterback		[n]（橄榄球）四分卫
handoff			[n]（橄榄球）手对手传球
ombudsman		[n]检察官
dog whistle		[n]向狗吹的哨，人听不到的声音；<<[politics>>有只有一小部分人能听懂的言外之意的话
mosey			[v]漫步；匆匆离开
bloodstained	[a]血染的
standpipe		[n]竖管，储水管
condone			[v]宽恕，赦免
ramrod			[n]上司，领导，用于清洁的小杆；[a]死板的，严峻的；[v]监督或指导；[adv]鲁莽地
parlance		[n]演讲，说话的风格或模式
binocular		[a]双眼的；[n]双筒望远镜
tantalum		[n]<<chemical>>钽
ionosphere		[n]离子层
mucus			
unbecoming		[a]不合时宜的，不适应场合的
felicitous		[a]适合场合的，幸福的，善于措辞的
mouthguards		[n]防护牙托
fuselage		[n]机身
circumpolar		[a]极地附近的
loincloth		[n]缠腰布
monsoon			[n]季风
palpable		[a]明显的，易感知的
payload			[n]使船或飞机正常运行的载重量
iodide			[n]<<chemical>>碘化物
rubidium		[n]<<chemical>>铷
whiteout		[n]一种极地雪盖地区的表面状况，所有物体都没有影子，看不见地平线，只能分辨黑色物体；严重降低可见度的风暴
bedrock			
snake oil		[n]被当做药品出售但没什么医学价值的东西；废话，大话
claptrap		[n]吹嘘的无意义的话，垃圾；[a]廉价花哨的
fudge			[v]伪造，篡改；闪避（问题）；越界，抄袭；表演未达到预期；（政治）避免承诺；[n]无意义的话；一种软的奶油糖，通常由糖、牛奶、黄油和调味品制成；伪造的东西；对规则的妥协或退步
hokeypokey		[n]街头零售商卖的冰激凌，没有意义的话
hokum			[n]吹嘘的无意义的话；用来引起观众注意的设备
humbug			[n]用来欺骗和误导的东西，误导性的人；欺骗和假装的态度或精神；无意义的话；[v]欺骗
piffle			[n]无意义的话；[v]
taradiddle		[n]无意义的话
tosh			[n]纯粹无意义的话
trumpery		[n]无意义的话
pear-shaped		[a]free from harshness, thinness, or nasality
secessionist	[n][a]分离主义
collarbone		[n]锁骨
famished		[a]饥饿的
skeeter			[n]蚊子，16英寸或更长的单帆破冰船
lobelia inflata	[n]<<biology>>
eucalyptus		[n]<<biology>>
armrest			[n]扶手
fumble			[v]笨拙或无目标地处理，不灵活地尝试做或寻找，通过摸索和错误搜索，弄糟，笨拙地移动，感到笨拙，未能接到滚地球，游戏中失误；[n]
grounder		[n]滚地球
grope			[v]摸索
scrabble		[v]摸索；乱涂；乱爬；努力追求
nibble			[v]细嚼慢咽；吹毛求疵
maraca			[n]用葫芦做成的一种打击乐器
percussion		[n]叩诊，打击乐器
gourd			[n]葫芦
purveyor		[n]承办商，提供粮食的人或公司
effluvium		[n]不可见的气体释放；恶臭；废气形式的副产品
deadwood		[n]死树；不重要的人或材料；当船太窄不能装框架时装在船首和船尾的实心木材；被击倒但仍在球道上的保龄球瓶
dross			[n]不想要的金属材料或浮渣；杂质；基础、不重要或次的东西
offal			[n]废料或副产品；垃圾
offscouring		[n]被驱逐的人
spilth			[n]spill的动作或实例；垃圾
riffraff		[n]乌合之众，流氓；[a]下贱的
on one's beam ends		当某人无计可施的时候
hyperbole		[n]夸张的言论，夸张
catch-22		[n]条件与结论相互未被的解决方案，因逻辑矛盾而不可能解决的问题
muscularis		[n]<<anatomy>>肌层
mantelpiece		[n]壁炉架
martian			[n]火星人
pick-up line	搭讪
wag				[v]摇晃（尾巴）；讨论；逃学；[n]
upmost			[a]非常重要的
Potemkin village		[n]用以隐藏不被希望的事实或状况的引人注目的表象
en banc			[a][adv]全体法官审理的
quorum			[n]
bushwhack		[v]埋伏；徒步穿过不容易穿过的地带，通过砍树和灌木清理一条路或前进
descend on (upon)		突然袭击，在上面突然恼人地出现
pittance		[n]一小笔，一点津贴或补偿
shoestring		[n]一小笔钱，不够用于完成交易的钱
chump change	[n]一小笔或不重要的钱
boodle			[n]一堆人；贿赂；一大笔钱
teat			[n]奶头，小的突出部分
shyster			[n]狂妄自大的律师
ne plus ultra	[n]最高点，极高的品质或状态
busker			[n]街头艺人
autodidact		[n]自学成才的人
sea monkey		[n]<<biology>>(Artemia salina)一种蛋生咸水虾，有时在鱼缸里养
Auriga			[n]
quicksilver		[n]水银
veracious		[a]真实的；诚实的
fib				[n]不重要或小孩子气的谎言；[v]说谎
cataplasm		[n]药膏
dressing		[n]穿衣的行为或实例；用于加在菜上的酱（如沙拉），用作填充物的调味混合物；敷在伤口上的膏药；化肥
manure			[n]农家肥；[v]施肥
venial			[a]可原谅的
day-to-day		[a]日常的
tetchy			[a]易怒的
touchy			[a]易怒的，不易满足的
sillibub		[n]syllabub
syllabub		[n]<<dietetics>>与酸性饮料(如葡萄酒或苹果酒)一起凝结的牛奶或奶油，通常加糖用作饮料或浇头，或用明胶增稠，用作甜点
screeve			[v]<<dialectal>><<British>>渗出（粘液）
jubilate		[v]使高兴，感觉高兴；[n]复活节后的第三个周日
crow			[v]发出乌鸦标志性的嘎嘎叫；非常愉快地大叫；由于另一个人的不行而幸灾乐祸；大肆吹嘘；[n]标志性胜利
as the crow flies		一条直线
porporate		[a]穿紫色衣服的
flanch			[n]纹章的两段中的一段；轮胎的螺纹；[v]向外倾斜；（up）（从烟囱）上升
cadge			[v]通过欺骗或劝说免费获得
sneer			[v]嘲笑；[n]；
flout			[v][n]蔑视，嘲笑
fleer			[v]用粗俗嘲弄的方式大小或做鬼脸
grimace			[v][n]充满讨厌、反对或痛苦的扭曲的面部表情
impudence		[n]批评，反对，蔑视
back talk		[n]批评，反对，蔑视
malapert		[n][a]不客气，厚脸皮
flue pipe		[n]烟筒
reed pipe		[n]<<instrument>>黄管
sulky			[a]有两个轮子和一个座位的；生气的，脸色阴沉的
mug				[n]=grimace；=mug shot；=punk，=thug；[v]摆姿势以拍照；[v]以抢劫为目的袭击；偷袭
snigger			[n][v]snicker
snicker			[n][v]窃笑
revelry			[n]狂欢，盛宴
merrymaking		[n][a]狂欢者
peregrinate		[v]步行，游览
onus			[n]责任，负担
onerous			[a]负担一样的；法律责任超过其益处的
trapezius		[n]<<anatomy>>
deltoid			[n]<<anatomy>>三角肌；[a]<<mathematics>>三角形的
plushie			
emirate			[n]酋长国
orangutan		[n]<<biology>>（脊椎动物）红毛猩猩
requite			[v]回报，报复
chatterbox		[n]非常喜欢说闲话的人
repay			
appraisal		
putz			
total			[v]
brothers in blue		
undertake		
asunder			
airsoft			
archery			
determinant		[n]<<math>>
bijective		[n]<<math>>
hailstorm		
heyday			[n]某人非常流行的时期
high noon		
floruit			
salad days		
springtime		
tweed			[n]
swoop			
mush			[n]<<dietetics>>用麦片做的麦片粥；像海绵一样或没有固定形状的软东西；多愁善感，没有味道的香料；[v]用由狗拉的雪橇在雪地上滑行，用于指挥狗；[n]由一队狗带领的雪地旅行
artichoke		[n]<<botany>>一种地中海地区高大的复合草本植物（Cynara scolymus， 石菖蒲属)，类似蓟，叶呈粗糙的羽状切开；朝鲜蓟，可食用
celery			[n]<<botany>>胡萝卜属的欧洲草本植物，尤其指一种可种植的类型（A. graveolens dulce)，叶柄可食用；芹菜
rocket salad	[n]<<botany>>芝麻菜
sauerkraut		[n]<<dietetics>>切细的卷心菜，在自己的汁液和盐制成的盐水中发酵
porcini mushroom		[n]<<botany>>牛肝菌
couscous		[n]<<botany>>非洲北部的一种用蒸粗粒小麦粉做的菜，通常和肉或蔬菜一起吃
cut fine		[n]<<dietetics>>精致切片
semolina		[n]<<botany>>粗粒小麦
zucchini		[n]<<botany>><<Italian>>一种光滑的、深绿色的圆柱形夏南瓜
squash			[n]<<dietetics>>南瓜；<<sports>>墙网球；拥挤的环境，挤压，挤压声；[v]压扁，挤进去，塞入；抑制；粉碎；去除；果断拒绝；使无言以对
mortadella		[n]<<dietetics>><<Italian>>一种意大利式熏肉肠
salami			[n]<<dietetics>><<Italian>>用猪肉或牛肉腌的肠
quail			[n]<<dietetics>>鹑鸡类的鸟类；Coturnix coturnix；[v]萎缩，下降；（勇气）放弃；害怕而后退
anchovy			[n]<<dietetics>><<biology>>鲱鱼科的一种小鱼（比如Engraulis encrasicholus），用作开胃菜或配菜，用来做酱汁或调味品；凤尾鱼
bass			[n]<<dietetics>><<biology>>鲈鱼；<<botany>>椴树
carp			[v]；[n]<<biology>><<dietetics>>一种大型亚洲浅水鲤鱼（Cyprinus carpio），常用作食物
grass carp		[n]<<biology>><<dietetics>>一种食草鲤鱼(Ctenopharyngodon idella），产自东亚，被引进其他地区一控制水生种子
Cyprinid		[n]<<biology>>鲤鱼科
caviar			[n]<<dietetics>>鱼子酱
cod				[n]<<dietetics>>鳕鱼；[v]愚弄，哄骗
crab			[n]<<dietetics>>螃蟹肉；起重机；[v]；
crayfish		[n]<<dietetics>>小龙虾
cuttlefish		[n]<<dietetics>><<biology>>乌贼
grouper			[n]<<dietetics>><<biology>>石斑鱼
monkfish		[n]<<dietetics>><<biology>>安康鱼
mullet			[n]<<dietetics>><<biology>>乌鱼
grunt			[n]<<biology>>刺鲈科，主要产于热带的海洋硬骨鱼类的一科（Haemulidae， 同义词Pomadasyidae），由于打捞时会产生呼噜声而得名；<<dietetics>>把饼干面团撒在煮熟的浆果上蒸做出来的一种甜品；美国越南战争时的步兵或海军士兵；每天做重复而不光彩工作的人，常用作定语[v]发出咕哝声
oyster			[n]<<dietetics>><<biology>>牡蛎；沉默寡言的人，常用作定语；一种灰白色；用于实现个人利益的东西；鸡背两侧骨盆骨凹处的一小块肌肉
gurnard			[n]<<dietetics>><<biology>>sea robin
sea robin		[n]<<dietetics>><<biology>>
scorpion fish	[n]<<dietetics>><<biology>>蝎子鱼
scallop			[n]<<dietetics>><<biology>>海洋生双壳鳃角类软体动物（family Pectinidae），外壳呈放射状，边缘呈波浪状，通过开启和关闭壳来游；食物用的扇贝内收肌；连续圆形片段或角状投射物组成的边界的一段（衣服或金属）；pattypan；=escalope，无骨的肉或鱼的一个切片；[v]；
pattypan		[n]<<botany>>一种扇贝形状的夏季南瓜，=cymling
sole			[n]<<dietetics>><<biology>>
sturgeon		[n]<<dietetics>><<biology>>大型伸长的沿河产卵的或潜水有骨鱼，在北方温带地区大量存在，鱼子通常被做成鱼子酱；鲟鱼
tuna			[n]<<dietetics>><<biology>>大型鲭亚目鱼类，用作食物和打猎；金枪鱼；[n]<<botany>>仙人掌属的一种
opuntia			[n]<<botany>><<Latin>>仙人掌属
albacore		[n]<<dietetics>><<biology>>鲭鱼
roe				[n]<<dietetics>>鱼卵，doe
doe				[n]雌性成年哺乳动物（如鹿，兔子或袋鼠）
buck			[n]雄性成年哺乳动物
béchamel		[n]<<dietetics>><<French>>一种油腻的白色酱
mascarpone		[n]<<dietetics>><<Italian>>一种意大利奶酪
mozzarella		[n]<<dietetics>><<Italian>>一种混合的白色不放盐半生奶酪，味道温和，质地光滑呈橡胶状
parmesan		[n]<<dietetics>>一种非常硬、干、味道强烈的奶酪，磨碎或成楔形出售
ricotta			[n]<<dietetics>><<Italian>>像cottage cheese的白色半熟乳清干酪
cottage cheese	[n]<<dietetics>>用脱脂牛奶的凝块做成的奶酪，=Dutch cheese，=pot cheese，=smearcase
whey			[n]<<dietetics>>乳清
basil			[n]<<dietetics>>罗勒属植物（Ocimum），用于调味，属于薄荷科
Ocimum			[n]<<botany>>薄荷植物唇形科的一个大属，在温暖气候大量存在，有反折花萼的花和非常短的花冠筒
caper			[n]<<dietetics>>刺山柑花蕾，用作调味剂
coriander		[n]<<dietetics>><<botany>>香菜
clove			[n]<<dietetics>><<botany>>丁香
oregano			[n]<<dietetics>><<botany>>牛至，用于调味
paprika			[n]<<dietetics>><<botany>>红辣椒，味道发甜
cumin			[n]<<dietetics>>孜然
saffron			[n]<<dietetics>><<biology>>紫色番红花（Crocus sativus）的深橙色、芳香且辛辣的干柱头，用于给植物上色和加味，也用作染料和制药；藏红花；中性的橙色到橙黄色中间的一种颜色
crocus			[n]<<biology>>番红花
asparagus		[n]<<biology>>芦笋
rosemary		[n]<<dietetics>><<botany>>迷迭香
sage			[n]<<dietetics>><<botany>>一种多年生欧洲薄荷（Salvia officinalis），叶呈灰绿色有芳香，用于给肉调味；鼠尾草
vanilla			[n][a]<<dietetics>><<botany>>热带美洲攀缘附生兰花的任一属(香草属);香草，香子兰
epiphytic		[a]<<botany>>附生植物的
tarragon		[n]<<dietetics>><<botany>>龙蒿（艾的一种），可用作香料
thyme			[n]<<dietetics>><<botany>>百里香，可用作香料
apricot			[n]<<dietetics>><<botany>>杏（Prunus armeniaca）；杏黄色
prunus			[n]<<botany>>李属
fig				[n]<<dietetics>><<botany>>桑葚科榕树属的有梨形或椭圆形的无花果；最少的一点点（都不关心）；穿着，打扮
passion fruit	[n]<<dietetics>><<botany>>百香果
oblong			[n][a]因一维伸长而偏离正方形、圆形或球形的
raspberry		[n]<<dietetics>><<botany>>覆盆子，（轻蔑/嘲笑）咂舌声
hazelnut		[n]<<dietetics>><<botany>>榛子
walnut			[n]<<dietetics>><<botany>>胡桃
pistachio		[n]<<dietetics>><<botany>>开心果（Pistacia vera）
chickpea		[n]<<dietetics>><<botany>>鹰嘴豆（Cicer arietinum）
lentil			[n]<<dietetics>><<botany>>小扁豆
cornstarch		[n]<<dietetics>>玉米淀粉
lard			[n]<<dietetics>>猪油
schnitzel		[n]<<dietetics>>烤牛排
margarine		[n]<<dietetics>>一种食物，由植物油和熟的脱脂牛奶搅拌成的光滑的奶油，像黄油一样使用；人造奶油
shortening		[n]<<dietetics>>一种可食用的脂肪，用来缩短烘焙食物的时间；起酥油
mayonnaise		[n]<<dietetics>>蛋黄酱
sake			[n]<<dietetics>>日本米酒
pine nut		[n]<<dietetics>>松子
quiche			[n]<<dietetics>><<French>>一种不加糖的蛋奶馅饼，馅料通常很可口(如菠菜、蘑菇或火腿)
patate			
fillet			[n][v]<<dietetics>>切片
fettuccine alfredo		
tartiflette		
tagliatelle alla bolognese		
mussel			[n]<<dietetics>>蚌
baba			[n]<<dietetics>>一种在朗姆酒和糖浆中浸泡过的油腻蛋糕
jacket potato	[n]<<dietetics>><<British>>带皮的烤土豆
tartare			[a]<<dietetics>>生吃的
pastry			[n]<<dietetics>>起酥点心
mille-feuille	[n]<<dietetics>><<French>>千层蛋糕
marinade		[n]<<dietetics>>腌好的菜；腌咸菜
drizzle			[n]小雨
jack-of-all-trades		[n]杂而不精的人，万事通
trampoline		[n]蹦床
homophobic		[a]害怕同性恋的
sitology		[n]饮食营养学
onomatology		[n]命名学
tonality		[n]音调
clay pigeon		[n]<<sports>>泥质飞靶
semitic			[n][a]
laughingstock	[n]滑稽的东西
jocular			[a]快乐的，喜欢开玩笑的
facetious		[a]喜欢开玩笑但不合适的，不严肃的
waggish			[a]幽默的
waggery			[n]调皮的快乐
pleasantry		[n]语言上的幽默，笑话，客气的社交行为
dork			[n]傻子
hitherto		[a][adv]直到那时
theretofore		[a][adv]直到那时
henceforward	[a][adv]从那时之后
henceforth		[a][adv]从那时之后
thenceforth		[a][adv]从那时之后
well-nigh		[adv]几乎
nitroglycerine	[n]<<chemical>><<medical>>硝化甘油
besot			[v]使迷恋，使糊涂
rencontre		[n]战斗性相遇，随意的相遇
amendment		[n]<<law>>修正法案
prohibitionist	[n]禁酒主义者
G-man			[n]FBI特工
blind pig		[n]非法卖酒处
intoxicant		[n]能喝醉的东西
scofflaw		[n]不遵守法律的醉酒者
booze cruise	[n]以卖酒或喝酒为目的的船上旅行
volsteadian		[a]禁酒的
bathtub gin		[n]用水、纯酒精、香精、精油做的自酿酒
shot in the dark		[n]有一点可能是正确的一次猜测
remembrance		[n]记忆，回忆，纪念品
subvocalization	[n]默读
exhort			[v]劝告，告诫
quiescent		[a]静止的，不活动的
peremptory		[a]强制的，专横的
kindred			[a]有关的
inveigh			[v]猛烈抗议或抱怨
trepidation		[n]恐惧
shunny			
whiskerfeathered		
apprehensive	
bully			[n]情人
gymnologize		[v]像印度哲学家一样裸体争论
litote			
paraleipsis		
pedagogue		[n]愚钝或咬文嚼字的老师
dystopia		
cineplex		
girth			
groomzilla		
hypovolenic		
mastectomy		
everglade		
ascarlasis		
seminarian		
egress			
grotesquerie	
lowbrow			
tautological	
butadiene		
narcolepsy		
ptetygium		
facismile		
accreditation	
psychedelic		[a]精神不正常的；模仿、诱发或产生类似幻觉药物的效果的
deity			[n]神；被尊敬为超自然力量的存在
preamble		[n]入门介绍，引言
prelude			[n][v]序曲，开幕式
conservatoire	[n]艺术学校
conservatory	[n]温室大棚；艺术学校
euphemistic		[a]用有礼貌的语言替换无礼貌的语言
embattle		[v]强化力量；准备战斗
unmoor			[v]解锚
purport			[v]（通常有似是而非的外表）意图为，宣城
verbiage		[n]大量使用没什么表意的罕见词；用词汇表达自己的方式
diction			[n]表达法，唱歌时的发音；按准确性、清晰度选择词汇
warble			[n][v]鸟鸣;颤音；有节奏的低音乐声；[n]牛皮肿，一种皮肤下的肿胀，尤指牛、马和野生哺乳动物的背部，因僵尸蝇或鸣蝇蛆的侵扰而引起
profuse			[a]大量倾倒，大量表现；大量存在
gushing			[a]大量出现的
riotous			[a]暴乱的；大量出现的
profusion		[n]大量出现，慷慨
ruddy			[a]红润的；<<British>>用于加强语气
rubicund		[a]脸色红润的
florid			[a]装饰华丽的；脸色红润的，有情感或性狂热的；（疾病）完全发展的
molasses		[n]<<dietetics>>糖浆
gingerbread		[n]<<dietetics>>用姜和糖浆做的蛋糕；（建筑物）过分装饰的
stagecraft		[n]舞台艺术
unionism		
yellow dog		
chappie			
pooch			
dogtrot			
dog tune		
proletariat		
canaille		
muttonhead		[n]傻瓜，笨蛋
mutt			[n]傻瓜，笨蛋
dog in the manger		[n]自己有东西不使用还不分享给别人的人
Sirius			
tosspot			
overtake		[v]赶上，超车
dog days of summer		
dogfall			
coydog			
mansplain		
oompa-loompa	[n]矮人
preteen			[n]小于13岁的孩子
boner			[n]愚蠢的错误
bone			[n]（争辩）对象；骰子；倾向；[v]去骨；为(衣服)提供支撑；打磨；努力学习；[adv]完全，非常
bone to pick	[n]争辩或抱怨的原因
oner			
glory hole		
serfdom			[n]农奴制度
gorilla			[n]大猩猩
flagellation	[n]鞭打
foreplay		[n]性交前的爱抚；前戏
dead-on			
oedipus			[n][a]恋母情结
adderall		[trademark]一种治疗注意力缺失或多动症的药
treasurer		[n]会计，财务主管
no-fly list		[n]禁飞名单
sedition		[n]暴动
phosphine		[n]磷化氢，无色有毒可燃的气体，用于给谷物消毒
limpid			[a]透明的；非常宁静、未被打扰的
bookmaker		[n]书签
accessorize		[v佩戴饰品
provisionally	[adv]临时地
pander			[n]拉皮条者，中间人；充分发掘别人弱点的人；[v]为他人的欲望提供使之满意的东西
gratification	[n]使人满意的东西
go-between		[n]中间人，媒介
defog			[v]去除迷雾
marxist			[n]马克思主义者
leninist		[n]列宁主义者
plenary			[n]全体出席的会议；[a]全体出席的；绝对的，全方面的
compleat		[a]有完全准备技能或原料的
crackerjack		[n]精通某种东西的人或物
levitate		[v]飘行，使飘行
levity			[n]过分或不适宜的轻浮；缺少稳定性
frothy			[a]起泡的，轻浮的
wellspring		[n]提供持续补给的源
fountainhead	[n]溪流的源泉，发源地
pellucid		[a]以透明为特点的
homophone		[n]同音异义词
operative word	[n]关键词
take in one's stride		轻松解决，从容处理
pallor			[n]脸色苍白
impersonal		[a]客观的；无人称的
discoverable	[a]显然的
affordance		[n]定义一个对象的可能用途或使它能够或应该如何被使用的性质或属性
typography		[n]印刷术；印刷格式
horrid			[a]令人震惊的，非常招人烦的，很不愉快的
throw off		摆脱
crabwise		[adv]横行地；小心翼翼地
operose			[a]需要大量工作的，冗长的
sinology		[n]汉学研究
fakir			[n]（伊斯兰教或印度教）苦行僧；冒充者
dervish			[n]（穆斯林）托钵僧
mendicant		[n]（穆斯林）托钵僧
apicultruist	[n]养蜂人
wind up			使结束
fly off the handle		大发雷霆
put sb out		给某人惹麻烦
run its course	让它自生自灭
maypole			[n]一个有花圈的柱子，用于五一节运动和舞蹈
attaché			[n]使馆专员
hands-on		[a]有实际经验的
on this account	因此
supervenient	[a]额外、外来或不被期望的
continuum		[n]<<mathematics>>连续统，一个不能被分割成两个集合且任何一个是有限集的集合；一个连续的整体，其中的元素有细微的差别
sentience		[n]感知，感知力
ethnography		[n]人类学
collective		[a]代表一个集合的；聚集的；集体的；公用的；[n]集体；集体农业；使电路在若干点可用的一组终端
performative	[a]性能的
constative		[a]命令式的
participatory	[a]多人参与的，与人分享的
one-shot operation		[n]只有一次机会的行动
veneer			[n]一薄片的某种原材料；保护或装饰性表面；假象，表面；[v]用一薄层木材覆盖以作为装饰或外层抛光
finish			[n]抛光
plywood			[n]胶合板
mantra			[n]一组神秘的召唤或咒语组成的公式
watchword		[n]用于识别一个群体的咒语；标志语
straddle		[v]跨步站立；不寻常地向外延伸；同时支持矛盾的两方；在问题上态度不明确；[n]中立的人；中立的位置
committal		[n]托运；承诺
consignment		[n]托运
mittimus		[n]收押令
noncommittal	[a]态度不明确的
straddle in the fence		中立或不决定
anorexia		[n]<<medical>>厌食
anorexia nervosa		[n]<<medical>>常见于女性十几岁或二十几岁的饮食习惯的严重失常，由对增重病理上的恐惧引起，导致不正确的饮食模式、营养不良遗迹通常伴随发生的过量减肥
sterling		[n]英镑；[a]银质的；符合高标准的
come down to	归根结底是
boil down to	归根结底是
ouroboros		[n]衔尾蛇
meteoric		[a]流星的；速度非常快，迅速出名的
bricolage		[n]用已有的东西创造（雕塑或想法）
putter			[v]漫无目的地行动或移动；随意地工作；[n]用来推的高尔夫球棒
putter about	磨磨蹭蹭地干活
externalize		[v]将事情归咎于外部原因
rationalize		[v]将事情归咎于外部原因
Socratic		[a]苏格拉底的，通过系统的怀疑和质疑来清晰表达真理
halibut			[n]<pl:halibut>大比目鱼
porcupine		[n]豪猪
potlatch		[n]冬季赠礼节（美洲印第安人冬季的一个节日）
gawk			[n]笨蛋；[v]笨拙地盯
gooey			[a]软、湿、黏的；过分伤感的
polaroid		[n]用于一种光偏光材料，尤其用于眼镜和灯以防止眩光，或用于产生已冲洗照片的照相机
amenity			[n]引起舒适或享受的东西；好的社交礼仪或行为；令人愉悦的品质
glen			[n]峡谷
pelican			[n]<<biology>>
unhinged		[a]精神错乱的
transvestite	[n][a]穿异性服装的
pouty			[a]噘嘴的，容易生气的
tocino			
spring roll		[n]<<dietetics>>春卷
soot			[n]烟灰
fuliginous		[a]煤色的，灰黑色的
dilatory		[a]拖沓的，延迟的
fugacious		[a]易消逝的
cajole			[v]用蜜言哄骗
vitriol			[n]恶言
longanimity		[n]长期忍受伤害的性格
glabrous		[a]表面光滑的，没有突出或毛发的
projection		[n]突出，投射
plumpness		[n]丰满
embonpoint		[n]丰满
wan				[a]苍白的，乏力的；暗淡的；[v]使苍白，使呈病态
dove			[n]鸽子；棕灰色
edema			[n]<<pathology>>水肿
monoxide		[n]一氧化物
child neglect	[n]忽视儿童，照管不良
chin up			振奋起来
stand tall		昂首站立
purgatory		[n]（天主教）炼狱；暂时的苦难
plushy			[a]长毛绒的，豪华的
guilty pleasure	罪恶快感
gleeful			[a]快乐的
glee			[n]快乐；男声唱的部分
sextant			[n]<<nautical>>六分仪
rambunctious	[a]标记为无法控制的自大的
recusant		[a]不服从政府的
restive			[a]倔强难以控制的；标记为不耐心或不安心的
refractory		[a]倔强的，不能管教的；治不好的；对刺激无反应的；免疫的；耐高温的
admissible		[a]可接受的
stochastic		[a]<<mathematics>>随机的
quadratic		[a]<<mathematics>>二次的
extremum		[n]<<mathematics>>极值
stationary point		[n]<<mathematics>>驻点，平稳点
saddle point	[n]<<mathematics>>鞍点
sash			[n][v]腰带，肩带
presuppose		[v]假定，以...为先决条件
nascent			[a]新兴的
perinatology	[n]<<medical>>围产期学（产前5个月和产后1个月）
ab initio		[adv]从头开始的计算
in silico		[a][adv]用硅的，用计算机完成的
panzer			[n]二战时期德国装甲部队
rearmement		[n]重整军队
preponderance	[n]重量、权利、重要或力量上的绝对优势；数量上的领先；大多数
prepotency		[n]领先的状态；由于大量显性基因的纯合性而使个体或种群将其性状遗传给后代的不寻常能力
ideation		[n]产生想法的能力
piste			[n]滑雪道
physiology		[n]生理学
gospel			[n]福音
nitty-gritty	[n]具体、基础、重要的细节
get down to brass tacks		来到重要的细节处
nuts and bolts	[n]重要细节，基础细节
disseminate		[v]宣传，广为流传
longitudinal	[a]长度的，纵向的，经度的
full-blown		[a]成熟的，盛开的
affective		[a]感情的，表达感情的
underdress		[n]内衣，内裙；[v]使穿着过分朴素
pedometer		[n]计步器
gaffe			[n]外交或社交失误；大过失
faux pas		[n]严重失误，社交尴尬或不合时宜的行为
white supremacist		[n]白人至上主义者
logorrhea		[n]非常能说话而且内容不连贯
inextricably	[adv]不可分割地
evangelize		[v]传福音；使信基督教
Christianity	[n]基督教
pachyderm		[n]<<biology>>非反刍的哺乳动物，包括大象、犀牛属、河马属
rhinoceros		[n]<<biology>>犀牛属
hippopotamus	[n]<<biology>>河马属
stasis			[n]静止状态
heckle			[v]用问题、质疑或愚弄骚扰或使烦恼
bona fide		[a][adv]善意的，真诚的
echt			[a]真实的，不虚假的
scarlet			[a]猩红色；粗暴而明目张胆地有攻击性；[n]
glaring			[a]明目张胆的
catch a chill	[n]感冒
far-fetched		[a]牵强附和的
look a gift horse in the mouth		[n]对别人给的东西挑毛病
string along	欺骗
till			[n]交款处，现金收纳机；[v]耕地
escritoire		[n]写字台
schadenfreude	[n]从他人的麻烦上获得的乐趣
diploid			[n]<<genetics>>二倍体
haploid			[n]<<genetics>>单倍体
nucleotide		[n]<<biology>>核苷酸
allele			[n]<<genetics>>等位基因
codon			[n]<<genetics>>密码子
homozygous		[a][n]<<genetics>>纯合子
heterozygous	[a][n]<<genetics>>杂合子
leitmotif		[n]主乐调
collogue		[v]密谋
gerontocracy	[n]老人统治
foothold		[n]立足点
phish			[v][n]网络钓鱼
file			[n][v]锉刀
enliven			[v]给予生机
quicken			[v]使复活，刺激；加速
vivify			[v]重新给予生机
malodorous		[a]有恶臭的；非常不正确的
prong			[n]刺
discriminant	[n]<<mathematics>>判别式
eigenvalue		[n]<<mathematics>>特征值
tandem			[n]串联
kiln			[n]窑
enclosure		[n]附件；圈地运动
injective		[a]<<mathematics>>单射的
asymptotic		[a]<<mathematics>>渐近线的
asymptotic analysis		[n]<<mathematics>>渐近分析
homologate		[v]允许，正式确认
misology		[n]对评论、讲道理的厌恶
mythomania		[n]对说谎或夸张的过分倾向
shill			[n][v]诱饵；推销员
Pinkerton		[n]私人侦探
amicus curiae	[n]<<Latin>>协助法庭解决特殊问题的人
trundle			[v]推以使滚动；用有轮子的车作为交通方式；滚动；[n]滚动的声音；圆形或椭圆形木桶
trundle bed		[n]有脚轮的床
inanition		[n]空虚的状态，由于饥渴而非常疲倦的状态，或缺少生气或士气
sedulous		[a]勤奋的，（干活）小心谨慎的
vibrissa		[n](pl. vibrissae)<<anatomy>>鼻毛；触须
insectivorous	[a]<<biology>>食虫的
redolent		[a]有芳香的；唤起回忆的
evocative		[a]趋向于唤起感情回忆的
revise			[v]改正；校订；重新分类；[n]证据修改的书面证据
tidings			[n]消息
fledgling		[n]<<attributive>>雏鸟；无经验的人
greenhorn		
neophyte		
novitiate		
tenderfoot		
tyro			
old hand		
signet			[n]替代签名的印；印留下的图案；（戒指上的）小凹雕印；[v]
befit			[v]适合于
dowdy			[a]破烂的；旧的；缺乏现代风格的
smartness		[n]现代风格
tipple			[v]连续小口喝酒；[n]筛煤场；装运煤的地方
strop			
ajar			[a][adv]轻微张开
welter			[v]滚动；深深陷入；[n]混乱，躁动，乱七八糟的一堆
voluble			[a]容易转动的；说话快的，流利的
toss about		滚来滚去
squall			[v][n]大声喊；[n]短暂的暴乱；雨或雪中的一阵强风
barnacle goose	[n]<<biology>>白额黑雁
sapling			[n]小树，胸高处直径不到4英寸的树；年轻人
nib				[n]嘴，笔尖
tureen			[n]装食物的有盖的碗
inveigle		[v]通过甜言蜜语哄骗
prig			[n]小偷；通过仔细观察用于或礼节而不断反对或提出质疑的人
rumpus			[n]乱哄哄的东西
bugbear			[n]用来吓人的假想的幽灵；令人恐惧的物体或来源；很棘手的问题
bête noire		[n]被极力厌恶或躲避的人或物
nostrum			[n]被制作者声称是秘密配方但没有任何科学证据的药；有问题的模式或解决方案
catholicon		[n]万能药
duplicitous		[a]有欺骗性的
svelte			[a]苗条的，柔和的
verdure			[n]植物的绿色，绿色植物；充满健康活力的状态
raiment			[n]衣物，装饰
habiliment		[n]标志；（plural）衣物，制服
homespun		[a]朴素的，在家里织的
imbroglio		[n]非常痛苦或尴尬的误解；丑闻；混乱痛苦的纷争；（文学作品中的）复杂的局势；混乱的一团
maladriot		[n]不灵活的，笨的
impolitic		[a]不明智的
epigone			[n]追随者；低级的模仿者
potboiler		[n]低级的（文学）工作，以养家糊口为主要目的
literatus		[n]文学界，学者
tricorn			[a]长三个角或有三个角落的
tea party		[n]茶话会
pother			[n]混乱或不安的活动，骚动；对一个不重要事情的令人烦恼的讨论；一大块烟或尘；思想上的混乱；[v]
cenacle			[n]休息室，尤其指罗马天主教女人在修女的指导下的休息室
cantle			[n]马鞍后面上升的部分；切下来的一部分
regnant			[a]统治的；有统治地位的；大量普及的
terpsichorean	[a]与舞蹈有关的
clerisy			[n]知识分子阶层
intelligentsia	[n]知识分子阶层
williwaw		[n]从高山上吹下来的强风；混乱的骚动
hypnopompic		[a]半有意识状态的
pule			[v]抱怨
bleat			[v]抱怨，啜泣；[n]羊叫
mewl			[v]猫叫，婴儿啜泣
sparge			[v]洒，喷
enmesh			[v]用网捕获
cogman			
hominine		[n]<<biology>>人科
homo erectus	[n]<<biology>>直立人类
eggfruit		
kingcraft		[n]治国术
calamine		[n]由氧化铁、氧化锌组成的矿石，用于擦洗或药膏
liniment		[n]擦剂
noncommissioned	[a]不在现役的，无委托的
effleurage		[n]（按摩）轻微一推
effloresce		[v]盛开；由于失去结晶水而形成粉末；形成或变成粉末一样的坚硬外壳
florescence		[n]花开的状态或季节
clef			[n]<<musical>>放在五线谱开头的谱号
treble clef		[n]<<musical>>高音谱号
bass clef		[n]<<musical>>低音谱号
repine			[v]（over）抱怨；希望得到某物
protoplasm		[n]<<biology>>由有机或无机物质组成的胶状物，构成细胞核、细胞质、线粒体等细胞成分
plastid			[n]<<biology>>色素体
chloroplast		[n]<<biology>>叶绿体
amyloplast		[n]<<biology>>生成和存储淀粉的无色色素体
starch			[n]淀粉；活跃；呆板正式的风格，正式风格
organelle		[n]<<biology>>细胞器，细胞质中由特定功能的各种微小结构的总称，包括线粒体、叶绿体、内质网、高尔基体、融媒体、微体等
nucleus			[n]<<biology>>细胞核
cytoplasm		[n]<<biology>>细胞质
colloidal		[a]<<biology>>胶质的，胶状的
middle lamella	[n]<<biology>>植物细胞的胞间层
vacuole			[n]<<biology>>液泡
Golgi apparatus	[n]<<biology>>高尔基体
saccule			[n]<<biology>>小囊，内耳迷路中的球囊
nucleolus		[n]<<biology>>核仁
ribosome		[n]<<biology>>
endoplasmic reticulum		[n]<<biology>>
centriole		[n]<<biology>>
lysosome		[n]<<biology>>
physiotherapist	[n]物理疗法
versity			[v]作诗；用诗描述
prolocutor		[n]发言人；主席，主持人
hylozoism		[n]希腊哲学家的一个理论，认为万物皆有声明
sixpenny		[a]值六便士的
upstanding		[a]直立的，健康的，身体笔直的
disadvantaged	[a]缺乏基础资源或生存条件以至于被认为是处于社会下层地位的
moorhen			[n]<<biology>>黑水鸭
schematic		[a]图解的
puppyhood		[n]小狗
picket			[n]尖木桩；前哨队伍；抗议队伍的领头；[v]用尖木桩防御；用绳子系上；提出抗议
bittersweet		[n]苦中带甜；<<botany>>白英；[a]
feverweed		[n]<<botany>>刺芹属植物
vindaloo		[n]<<dietetics>>（印度）（用蒜、酒等配制的）咖喱肉
avifauna		[n]一个区域内的鸟类
fructuous		[a]果实产量高的
homey			[a]像家一样的；平凡的；[n]老乡
uptake			[n]理解力；向上的烟筒；像生物组织或细胞汲取
cyclothymic		[a][n]比狂躁症弱的情绪失调，表现为间歇性的悲伤或兴奋的爆发
wheelie bin		[n]带轮的大垃圾桶
pro rata		<<Latin>>按比例的
stare decisis	<<Latin>>遵循先例
immaterial		[a]不重要的
squelch			
circumambages	[n]用语隐晦或曲折
paromologia		[n]对对手的婉转让步，意在增强己方观点
sophism			[n]表面正确但实际上不正确或有欺骗性的论证
fallacious		
preterition		
pretermission	
mudslinging		
apophasis		[n]不直接地断言某事是正确的的场合
tergiversation	[n]闪烁其词，不直接给出答案
tergiversant	[a]
tergiversate	[v]
irregardless	[a]
stuffing		
dope			
zipper			
parka			
palataize		[v]<<Phonetics>>使颚化
claque			[n]一群奉承者；一群请来在演出中鼓掌的人
sycophant		[n][a]阿谀奉承的
rostrum			[n]讲台，船头，鸟喙
galley			[n]完全由桨推动的船，古代战舰；船上的厨房或厨房器具
typeset			[n][v]排版，排字
oar				[n]桨
prow			[n]船头；[a]勇敢的
passim			[adv]到处
sic passim		[n]在一个作品中总能见到的词汇或想法
repand			[a]有轻微波浪形边缘的
innervate		[v]<<biology>>提供神经
pylorus			[n]<<anatomy>>幽门
tamale			[n]<<dietetics>><<Mexican>>玉米粉蒸肉
retardant		[a][n]<<chemical>>阻碍剂
cathode			[n]<<chemical>>（电解池）阴极
ray tube		[n]射线管
capacitor		[n]<<physics>>电容器
tumble drier	[n]滚筒烘干机
light-hearted	[a]轻松地，无忧无虑的
opinionated		[a]固执己见的
paradoxical		[a]矛盾的
risotto			[n]<<dietetics>>意大利烩饭
top-notch		[a]一流的
panhandle		[v]在街上乞讨；[n]柄状的狭长区域
hardscrabble	[a]贫瘠的
norm			[n]<<mathematics>>范数
geodesic		[n][a]测地线
commutative		[a]<<mathematics>>交换的
division algebra		[n]<<mathematics>>可除代数
polar decomposition		[n]<<physics>>极分解
gimbal			[n]可以转向各个方向的平衡环
guttersnipe		[n]
tanner			
blasé			[a]
neologism		[n]新词
dark pattern	[n]精心设计以使用户不小心使用的UI，意在让用户购买其本不想买的东西或提高自己网站的知名度
synagogue		[n]犹太人聚集处
sidesplitting	[a]特别搞笑的
uproarious		[a]非常喧嚣的；混乱的；非常可笑的
ludicrous		[a]通过明显的荒唐、不一致、夸大或奇怪来引笑的
farcical		[a]搞笑的；荒唐的
chucklesome		[a]咯咯笑的
antic			[a]姿势滑稽的，搞笑的
doxology		[a]对上帝的赞歌
synecdoche		[n]提喻（用局部代替整体，用材料代替物体）
metonymy		[n]转喻（用一个事物的特征性标志代替事物）
malarkey		[n]不真诚或愚蠢的话，空话
fracking		[n]将液体注入页岩岩床上以取出汽油或天然气
shale			[n]页岩，泥板岩
tear along		狂奔
belt along		狂奔
reticulate		[a]网状的；<<genetics>>依赖于遗传重组(包括不同的杂交种群)的进化的；[v]分割或重构以形成一张网
action figure	[n]手办
congratulatory	[a]值得庆祝的
coup de main	[n]一次突然袭击
marsupial		[a]<<biology>>有袋的；[n]
frangible		[a]容易破碎的
friable			[a]容易碾碎的
peckish			[a]饥饿的，急躁的
trough			[n]水槽；<<physics>>波谷
prima facie		[adv]第一眼看上去；[a]非常明显的；自我解释的；不需要证明的（证据）
ostensible		[a]明显的；表面是一回事可又可疑的
ostensive		[a]明显的
exploratory		[a]实验性的
confirmatory	[a]证实的
a priori		[a]<<Latin>>推演的，数学归纳法中初始条件的
a posteriori	[a]<<Latin>>归纳的
postseason		[n]季后赛
outsource		[v]用外国货企业外的供应商提供的材料生产
insource		[v]
back-office		[n]后勤部门
haulier			[n]<<British>>搬运工；自动搬运垃圾的车
vegetation		[n]一个地区的完全植物覆盖；惰性的存在；身体上长出来的不正常的东西
bear out		证实，支持
on par with		与...同等水平
officialdom		[n]官场，官僚作风
fungible		[a]可以取代的；可以用作货币的
fungibility		[n]可取代性
debatable		[a]有争议的
discretise		[v]<<cs>>离散化
etiology		[n]<<medical>>病理学
moat			[n]中世纪城堡外的战壕，城墙或其他防御工事，通常用水包围
battering ram	[n]破城锤
drawbridge		[n]可开闭的吊桥
nepenthe		[n]古人制作的一种药水，能使人忘记疼痛或悲伤；舒缓情绪的东西
tintinnabulation		[n]铃铛响
surcease		[v]结束
dissever		[v]使分裂
picturedrome	[n]电影院
back lot		[n]露天电影院
cusp			[n]<<mathematics>>奇点；尖端
crunode			[n]<<mathematics>>
acnode			[n]<<mathematics>>
nail-biter		[n]紧张的局势
suprachiasmatic nucleus		[n]<<anatomy>>
hypothalamus	[n]<<anatomy>>
chiasma			[n]<<anatomy>>
circadian		[a]以24小时为周期的
entrain			[v]被卷入并一起移动（粒子或气体）；决定或改变...的形态或周期；上火车
roadmap			[n]向目标前进的详细计划；详细的解释
ground plan		[n]建筑物一层的蓝图；第一个或基础计划
vie				[v]竞争
bailiff			[n]执法官
bailiwick		[n]法警办公室或管辖范围；有特殊知识或权限的领域
reprove			[v]谴责；训斥
octothorpe		[n]#号
hash			[v]把食物切成小块；使迷惑；（over, out)谈论，给出观点；[n]切好的食物；废话；混乱的一团；对旧事物的重新使用或提及
mishmash		
mixed bag		
muddle			
omnium-gatherum	
ragbag			
ragout			
salmagundi		
gallimaufry		
crazy quilt		
overarching		[a]首要的
at the outside	
farrier			[n]给马上鞋的人
ferrum			[n]<<chemical>>铁
doyenne			
recidivism		
mean feat		
eloquent		
lewd			
capade			
phalanx			
masochism		
by and large	
chalk up		
aubergine		[n]<<dietetics>><<British>>茄子
courgette		[n]<<dietetics>>西葫芦
ladle			
mac and cheese	[n]<<dietetics>>通心粉和奶酪
Brussels		比利时首都
satsuma			[n]<<dietetics>>蜜桔的一种
venison			[n]<<dietetics>>鹿肉
sirloin			[n]<<dietetics>>牛里脊
rump steak		
cox				[n]
romaine			[n]<<dietetics>>（=cos lettuce）（Lactuca sativa）生菜的一种
columnar		[a]
babycorn		
sugarsnap		
prosciutto		[n]<<dietetics>><<Italian>>熏火腿
dichotomy		[a]将一个部分分成两个互斥或对立的两个群体或实体；看起来自相矛盾的事物；分叉
somaesthetic	[a]<<biology>>包括表皮感官和运动感官的身体感觉
volition		[n]自主选择权
volitional		[a]主动的，有意识的
enteric			[a]<<biology>>关于或影响肠道的
integumentary	[a]<<biology>>关于表皮或外层（皮肤、毛发、鳞、羽毛、角质）的；与皮肤有关的
adipose tissue	[a]<<biology>>
skeletal		[a]<<biology>>关于、形成、或像骨架的
circulatory		[a]<<biology>>与循环系统有关的
anabolism		[a]<<biology>>新陈代谢的合成作用
myelin			[n]<<biology>>髓磷脂
myelinated		[a]<<biology>>有髓鞘的
nutrient		[a]提供营养的
multicausal		[a]多原因的
Ayurveda		[n]<<medical>>一种印度的草药按摩法
sated			[a]饱足的
vigil			[n]守夜；夜间祷告
consubstantiation		[n]<<Christian>>
eucharistic		[a]圣餐的；[n]
transubstantiation		[n]
lame duck		[n]<<British>>不景气的公司，在竞争中处于落后地位的人；在选举到就职期间被选择作为政府的组织；任期马上就要结束的人
inauguration	[n]就职典礼
investiture		[n]授职仪式；包装或装饰物
ratify			[v]正式确认
sanction		[n]基督教学位；誓言；对违法行为的处罚；信条；用于强制执行社会标准的社会机制；正式允许；[v]
precatory		[a]表达遗愿的
affiant			[b]宣誓过的人
deponent		[n]宣誓证人；[a]处于被动词形但是有主动表意的动词
wage slave		[n]指望工资活命的人
proslavery		[a]崇尚奴隶制度的
sanctimonious	[a]假装虔诚的
twee			[a]故作多情的
cosy			[n]保护罩
autologous		
phraseological	[a]措辞上的
phraseology		[n]
autosome		[n]<<genetics>>常染色体
autosomal		[n]<<genetics>>常染色体的
recessive		[n]<<genetics>>隐性的；只在纯合条件下表现性状的
penetrance		[n]<<genetics>>在给定条件下一个个体中某个特定基因使得其可以显现形状的占比
expressivity	[n]<<genetics>>某个特定基因的影响形状的能力
Mendellian		[n]<<genetics>>孟德尔遗传定律的
pedigree		[n]家谱；来源；纯种
geusioleptic	[a]乐于助人的，表达善意的
pediculous		[a]长虱子的
gemütlich		[a]令人愉悦的
psychagogic		[a]吸引人的，有改变人观点能力的
scaramouch		[n]胆小鬼
sniptious		[a]有魅力的，聪明的
gamphrel		[n]<<Scottish>>笨蛋
bezonian		[n]<<archaic>>流氓；士兵
barnburner		[n]非常有趣的东西
red herring		[n]腌制的深棕色鲱鱼；用于吸引注意力从而进行真正目的的东西
put all one's eggs in one basket		
beat a dead horse		
put out to pasture		
separate the wheat from the chaff		
a hard row to hoe		
when pigs fly with their tails forward		
bought the farm	
promiscuity		[n]随机的性行为；无标准的选择
wild oats		
cantaloupe		[n]<<dietetics>>哈密瓜
guppy			[n]<<dietetics>>孔雀鱼
arithmocracy	[n]群众统治
pornocracy		[n]妓女统治
ideocracy		[n]抽象思想统治的社会或政府
gynecocracy		[n]女人统治
sociocracy		[n]全民统治
queendom		[n]由女王统治的地区；女王身位
androcracy		[n]男人统治
patriarchy		[n]父权制，父系社会
homunculus		[n]矮人
preformation	[n]
mesocracy		[n]中产阶级统治
kakistocracy	[n]由不好的人统治
plutocracy		[n]富人统治
hagiocracy		[n]神权统治
tikka masala	[n]<<dietetics>>
kipper			[n]<<dietetics>>
schmear			[n]全部相关的事物
ball of wax		[n]全部细节
sallow			[n]黄华柳；土黄色
mercantilism	[n]商人主义
fulvous			[a]深棕黄色的；黄褐色的
tawny			[a]黄褐色的，茶色的
panorama		[n]全域；问题的全部方面
cyclorama		
panoramic		[a]展示全局的；全方面理解或包含的
take hold		
purr			
jaded			[a]由于工作而疲劳的；由于某物见得太多而麻木或不关心的
gestalt			[n]由许多部分组成的事物，而其表现与各个零件又有所区分
at odds			
ipso facto		[adv]<<Latin>>不可避免地
draw lots		
give sb a leg up		圈起拳头以帮某人爬上某物；帮某人一把
media hyper		媒体炒作
a storm in a teacup		
to step on the gas		
to put one's foot down		
weigh up		仔细观察某人以做出评价
taphonomy		[n]研究埋葬、腐烂和保存的学问
fashionista		[n]最新时尚的设计师、推销员或跟随者
fraudster		[n]<<British>>骗子
fly off the handle		发脾气
blow one's top	发脾气
go off one's rocker		发疯
come a cropper	残败，落马
be dead set		
dig one's heels in		
mill about		（人群）漫无目的地游荡
swarm about		无目的地游荡
have pins and needles		焦躁不安
furlough		[n][v]休假；临时解雇
hit a snag		（with）有问题
bullring		[n]斗牛场
amphitheatre	
onlooker		[n]检察员
knockabout		[a]可以用来做粗活的；喧嚣的
bowsprit		[n]<<nautical>>船首斜桅
topmast			[n]<<nautical>>中桅
crenel			
crenellation	
kerb			[n]<<British>>缰绳
loophole		[n]漏洞；枪眼；换气孔
epistatic		[a]<<genetics>>
metabolic syndrome		
frizz			
flyaway			
sleek			[v]掩盖；打磨；[a]圆滑的；看着身体状态好的；很好的；气氛和谐的
melanin			[n]<<biology>>褐色、红棕色的色素，由动物体产生（如作用于皮毛）
armour-plating	
on castors		
scrap iron		
clank			
with the colours		
houseman		[n]仆人
dissension		[n]不合，争吵
takings			[n]<<British>>收据
hot air			[n]无实质内容的讲话
cowhide			[n]牛皮
lean times		
victual			[n]食物
thither			[a][adv]那里；远处的
thitherto		[adv]直到那时
chut			[interj]表达不耐烦
antebellum		[a]战前的；美国内战前的
epistemic		[a]认知的
chime in		[v]和谐地组合；进入一个容易产生观点的讨论
red-letter day	[n]非常重要而开心的一天
fodder			[n]喂牲畜的粗粮；用于补给大量需求的低级材料
capitulate		[v]放弃抵抗；在几轮协商后妥协
fairy			[n]仙女
facula			[n]在太阳边缘处可见的光斑
fadeless		[a]不褪色的，不凋落的
faerie			[n]仙女；仙境
fairyland		[n]仙境
fahrenheit		[n]华氏温度计
fain			[a]园艺的；被驱使的；[adv]快乐地；希望，愿意
faintheart		[a][n]懦夫
fainthearted	[a]胆小的
faints			[n]劣质酒精
fair-headed		[a]金发的
fair-minded		[a]公平的
fair-trade		[n]公平交易
fair-weather	[a]只在成功时忠实的；适合晴天启航的
fairgrounds		[n]举行集会的露天场所
falcate			[a]镰刀或钩状的
falchion		[a]中世纪稍弯的刀
falciform		[a]镰刀状的
fall-pipe		[n]
fallacy			[n]谬论；欺骗性的表面
erroneous		[a]
fallaway		[a]远离篮筐方向的（投球）
false-card		[n][v]（牌戏）用于欺骗对手的一招
falsetto		[n]假音；假音歌手;[adv]
fandangle		[n]无意义的话；夸张的装饰
tomfoolery		[n]淘气或愚蠢的行为
fancywork		[n]装饰性的针线活
fanfold			[a]像风车一样的
fantastico		[n]疯狂追随者
far-sighted		
faraday			[n]法拉第
fare-thee-well	
farina			[n]淀粉
farinaceous		
farinose		[a]粉末状的；产生淀粉的
farouche		[a]狂野的；没有社交礼节的
farraginous		
farrow			[v]生（小猪）；[n]一群小猪；[a]（牛）未怀孕的
fasciate		[a]有横条颜色的
fascine			[n]柴捆
fast-talk		[n]
revetment		[n]护壁，护墙
fastigiate		[a]尖端变细的
fastigium		[n]发病的高峰期；（脑）尖顶
fastness		[n]堡垒
fastuous		[a]傲慢的；张扬的
fatidic			[a]与先知有关的
fatso			[n]胖人
fatuity			[n]愚蠢
fauces			[n]<<anatomy>>喉咙
faucal			[a]喉咙的
faultfinder		[n]吹毛求疵的人
fauna			[n]动物群
fauvism			[n]一种画派，特点为鲜艳的颜色、没有形式的约束以获得装饰的效果
faze			[v]使不镇定，打乱
fealty			[n]（封建制度）忠诚
featherbed		[v]雇佣超过需要的员工；将产量降低到标准以下；通过政府援助帮助
thine			
sotto voce		<<Italian>>低声
ermine			[n]<<biology>>
viatical settlement		[n]
rudderless		
contrition		[n]后悔
repentance		[n]后悔
salubrious		[a]有益健康的
cowshed			[n]牛圈
lockout			[n][v]停工
a string of		[a]一系列
abseil			[v]<<British>>锁降
sit out			被禁止参与
debenture		[n]<<British>>界限，信用债券
snap up			[v]快速或着急地购买（某物）或拿走（某人）
entente			[n]协约国，协约
prolly			[adv]大概
sandpaper		[n][v]砂纸
yammer			[v]大声持续抱怨；[n]
pisspot			[n]酒鬼
sleazebag		[n]卑鄙的人
Coulomb			库仑
prenhensile		[a]善于抓的；善于领会的
implication		[n]<<logical>>蕴含；建议；联系，共谋
frigid			
jalopy			[n]破旧的车辆
douchecanoe		
rockerboy		
assmunch		
egotist			[n]过度使用第一人称单数；以自我为中心
take a fancy to	莫名其妙地喜爱
idiopathic		[a]自发产生原因不明确的；私人的
whence			[adv][conj][pron]何处，从何处
from whence		从哪里
polyhedron		[n]多面体
decahedron		[n]十面体
panegyric		[n]颂词
encomium		[n]赞颂，颂词
chockablock		[a]紧贴在一起的；非常满的
chock			[n]木楔；[adv]紧贴在一起的
tuber			[n]块茎
writ			[n]令状
detinue			[n]非法占有
hyperbaric		
cynosure		[n]小熊座；关注的焦点
stardust		[n]浪漫、魔法或超现实的感觉
exenterate		[v]去除某物（轨道、转轴）的内容
scabbard		[n]剑鞘
sacral			[a]<<anatomy>>骶骨的
haggis			[n]<<British>><<dietetics>>肉馅羊肚，由羊或小牛的内脏构成，辅以羊油、葱、燕麦和咸菜
suet			[n]<<dietetics>>板油，从牛羊肾和腰上提取出的硬脂肪
neep			[n]<<British>>萝卜
septuagenarian	[n]七十多岁的人
emendation		
dunder			[n]<<Scottish>>像打雷一样的短暂噪音；甘蔗渣，用于朗姆酒蒸馏时的发酵
lees			[n]发酵过程中液体中的渣
dorky			[a]傻；不知所措的
lamebrain		[n]笨蛋
lunk			[n]笨蛋
lunkheaded		[n]笨蛋
hipster			[n]非常热衷于新式不传统样式（爵士乐、时尚）的
lingo			[n]不能理解的语言或语言片段，如外语、专业词汇；个人的用于习惯
patois			[n]方言；只能被特殊群体理解的语言
patter			[v]像机器一样快速单调地说；机械地被祷词；大量地说；像戏剧一样地快速说；[n]（罪犯用的）特别词汇；毫无意义的谈话；[v]快速反复打击
spiel			[v]放音乐；健谈或夸张地说；[n]健谈且夸张的谈话
shoptalk		[n]特别领域的专用词汇
florilegium		[n]诗集
collectanea		[n]<pl.>收集到一起的文学作品
vox populi		[n]人民的声音，大众共同的想法或感觉
instrumentation	[n]乐器搭配，orchestration
chartreuse		[n]亮黄绿色
wisteria		
fuchsia			
periwinkle		
taupe			[n]<<colour>>棕灰色
nondescript		
precarious		[a]依赖于环境的；缺乏稳定性和安全性的；基于不确定的事实的
sequitur		[n]推理的结果
ensue			[v]追求；作为结果或在之后发生
extirpate		[v]连根拔除；手术切除
good-humoured	[a]快乐的
eupeptic		[a]消化好的；乐观的，快乐的
dicker			[n]十匹（布）；[v]讨价还价
eclogue			[n]牧羊人用的诗歌
expiate			[v]免除责任；赎罪
procreate		[v]产生
engender		[v]产生
dour			[a]沉闷的；阴郁的；不屈服的
obstinate		[a]倔强的；不屈服的
demur			[v]（to,at）反对；[n]抗议；（由于怀疑提供的东西的真实性）迟疑
expostulate		[v]用理由反对
remonstrance	[n]争辩
remonstrate		[v]用理由反对
dissuade		[v]劝说不要做
defray			[n]支付
brat			
disquisition	[n]对某一话题的正式追查
erasure			[n]擦除的行为
descry			[v]发现；看见
fester			[v]产生脓；腐烂；变得更加有毒、烦躁或不友好；[n]
pustule			[n]化脓
whelk			[n]<<dermatology>>青春痘；<<biology>>峨螺
suppurate		[v]化脓，溃烂
filly			[n]四岁以下的雌马；小女孩
fiasco			[n]彻底失败；长颈瓶
fern			[n]<<biology>>蕨类植物
fidget			[v][n]使烦躁
expound			[v]陈述；用观点防御；仔细解释
ventilate		[v]使公开
winnow			
flange			[n]凸缘；[v]装凸缘
flick			[n]犀利清淡的一笔或一次移动；[v]轻快地移动；轻抚；快速地一击；快速阅览
flannel			
flask			[n]长颈容器
finicky			[a]胃口要求或要求高的；需要特别关注的
fussbudget		[n]对细节过分关注的人
exacting		[a]对细节过分关注的；要求高注意力和准确性的
persnickety		[a]对细节过分关注的
flax			[n]（attributive）亚麻
flair			[n]才华，偏好；独特的风格
flaccid			[a]不结实的；缺乏生机的
limp			[v]无精打采地走；蹒跚；[n]蹒跚一步；[a]缺乏纹理、架构或支撑的；不紧实或坚硬的；累坏的；无精神的
lank			[a]瘦的；数量、长度或维度低的；不弯曲或曲折的
floppy			[a]软、易折断的
droopy			[a]下垂的，凋谢的
purview			[n]法规的条款、目的或作用域；理解、视野或认知范围
hamartia		[n]英雄人物的致命弱点
trafic flaw		[n]英雄人物的致命弱点
doldrums		[n]<<plural>>不精神的状态；沉睡咒
despondency		[n]被鄙视，无望
disconsolate	[a]不活跃的；被鄙视的，被啜泣的
doleful			[a]不活跃的；悲伤的
heartsick		[a]悲伤的
onanism			[n]自慰
onanist			[n]自慰者
newfound		[a]新发现的
chum			[n]密友；[v]一起生活；表达友情；（around）与某人一起；[n]用于鱼饵的动植物小块；[v]有鱼饵吸引；[n]鲑鱼
cesspool		[n]下水道；安葬或被腐蚀的地方或状态
maudlin			[a]醉酒而愚蠢；情感脆弱的
chocolate-box	[a]表面好看或感性的
fruity			[a]非常有效、有趣或享乐的；过分甜或感性的；（声音）宽厚的；傻
lovey-dovey		[a]表达爱或感情的
mushy			[a]软的；缺乏决断或准确的；过分感性的
novella			[n](pl. novelle, novellas)长度适中的虚幻作品
novelettish		[a]像科幻小说的
soppy			[a]过分表达感情的；很湿的
soupy			[a]粥一样的；云雾密集的；过分感性的
propitious		[a]善意的；有好处的
rose-coloured	[a]乐观的
Sagittarius		[n]射手座
quixotic		[a]难以预测的，变化无常的；追求理想而不现实的
throwback		[n]唤醒旧时记忆的东西；退回早期状态
atavism			[n]<<genetics>>返祖，隔代遗传
chiropodist		[n]足疗
podiatry		[n]足疗
ballpark		[n]举行球类运动的公园或场地；比较和折中可以进行的地方；[a]估计的，大概正确的；[v]估计
in the ballpark	大概正确
fait accompli	[a]已完成不能撤回的事
baseboard		[n]基板，脚板
tamarisk		[n]柽柳（刺绣用的）
willow			[n][a]柳树
wolver			[n]捕狼者；行为像狼的
heft			[n]重量；重要性；[v]掂量；举起
heave			[v][n]举起；起伏；投掷；恶心，呕吐
orca			[n]杀手鲸
vacate			[v]放弃职位；宣布不合法
leprous			[a]有麻风病的
scaly			[a]有鳞的；令人鄙视的，贫穷的
barley-hood		[a]醉酒；喝酒而导致的坏脾气
draffsack		[n]好吃懒做的人
eleemosynary	[a]与慈善有关的，被慈善扶持的
fustigate		[v]严厉批评；用东西打
cudgel			[n]短重棍；[v]
mammothrept		[n]惯坏的孩子
marplot			[n]捣乱的人
wanton			[a]没有人性的；恶意的；不合适地过分多的；淘气的；下流的；淫秽的；[n]惯坏的孩子；[v]
frolicsome		[a]快乐的
soupçon			[n]一点点，痕迹，迹象
nescience		[n]无知
flibbertigibbet	[n]愚蠢又不停歇的人
nosocomial		[a]发生在医院里的
agathokakological		[a]好坏参半的
avoirdupois		[n]体重
gelid			[a]非常冷的
odium			[n]由于可鄙的行为或坏境而被讨厌或藐视；仇恨与厌恶；臭名昭著
opprobrium		[n]带来羞耻的东西；蔑视
townspeople		[n]村里人
upbraid			[v]严厉批评，挑毛病
snow day		[n]在常年不下雪的地方由于下雪而学校停课
valetudinarian	[n][a]虚弱多病的人
knickknack		[n]小东西
knickknacktory	[n]一堆乱七八糟小东西组成的集合
ephemera		[n]不值钱的东西；用一次后丢弃的纸质物品但是成为了收集品
tchotchke		[n]小东西
contraremonstrance		[n]对争辩的争辩
schism			[n]分歧；教会分歧
ecclesiastical	[a]与教区有关的
futilitarian	[n]认为一切人类的挣扎都是徒劳的的思想
batrachophagous	[a]以青蛙为食的
antepenultimate	[n][a]一序列里倒数第三个
contrasuggestible		[a]趋向于做一个建议相反的事的
brobdingnagian	[n][a]（格列佛游记）大人国的；巨大的
Polyphemian		[n]巨人
epistemophilia	[n]热爱知识；对知识过分的追求
weltanschauung	[n]从一个特殊的立场对世界的复杂的理解
postremogeniture		[n]年龄最小的儿子或女儿继承的体系
noel			[n]圣诞节；圣诞节颂歌
neonate			[n]新生儿；不到一个月的孩子
bambino			[n]婴儿
Shrove Tuesday	[n]忏悔星期二
Mardi Gras		[n]忏悔节的狂欢
verdigris		[n]铜底部或表面的绿色或偏蓝色的沉淀
pneumonia		[n]<<medical>>肺炎
get set in one's ways		墨守成规
get bogged down	陷入困境
at sixes and sevens		乱七八糟
to be all at sea		不知所措
wakeboard		[n]花式滑水
motorboat		[n]摩托艇
debridement		[n]<<medical>>创伤、无活性或受污染组织的手术移除
chassis			[n]支撑车辆或电视的框架
nit-pick		[v]吹毛求疵
hearty			[a]异常兴奋的；毫无掩饰地表达感情的；身体健康的；胃口好的；生机勃勃的；[n]身体健康的人；水手
palmaris		[n]<<anatomy>>手掌骨两块中的任意一块
unrequited		[a]不能挽回的
vouchsafe		[v]以慷慨或居高临下的方式装饰或授权；将...作为特权或特别帮助
craniectomy		[n]<<medical>>手术移除头骨的一部分
old maid		
spinster		
irons in the fire		
lath			[n]钉在木筏、壁骨或搁栅上的窄木条作为基础；作为塑料基础的建筑材料；一定数量的lath
joist			[n]短木板或金属柱，平行排列于墙根以支撑地板或天花板
studding		[n]建筑或墙的支撑物
scantling		[n]少量；木材或石头的尺寸
interstice		[n]紧密排列的东西之间的间隔；事件之间的短间隔
pennant			[n]用于标识或示意的航海旗帜；一头粗逐渐变细成一点的旗帜；（棒球联赛）冠军的象征；冠军
banderole		[n]长分叉的旗帜；刻有铭文或装置的长卷
banner			[n]领袖使用的连接在物体一端的一小块布；旗帜；作为荣耀或区分的标志；报纸大标题；用于打印标志的一条布；一个集体或共同意识体的名字、标语或目标；www上的可视化标题；[v]；[a]支持一个政治团体的；在优秀程度上区分与其他人的
guidon			[n]小旗，作为单位标识的军事单位使用的旗；拿着guidon的人
pennon			[n]三角状或燕尾旗，通常连接在长矛上作为标志；翅膀
pinion			[n]翅膀
streamer		[n]在风中飘扬的旗帜；传输数据的端；只在日全食可见的太阳日冕
aurora borealis	北半球发生的日冕
northern lights	北半球发生的日冕
swallowtail		[n]燕子的深层分叉尖端变细的尾；燕尾服
tailcoat		[n]燕尾服
boozehound		[n]醉汉
dipsomaniac		[n]不可控制的酒精瘾
drunkard		[n]醉汉
juicehead		[n]醉汉
juicer			[n]醉汉
rummy			[n]醉汉；[a]
tippler			[v]过量喝酒；[n]车辆装载或卸货的地方或装置
toper			[n]醉汉
crocked			[n]醉汉
gassed			[a]醉汉
tiddly			[a]轻微喝醉的
billiard		[n]<<sports>>台球
miscue			[n]错误，过失；在台球比赛中球杆滑倒的错误一杆
slipup			[n]错误；[v]大错误
mischance		[n]糟糕的运气；坏运气的一次发作
champ			[v][n]猛踩；使嚼；由于延误或限制而感到不耐烦
thicket			[n]密集生长的灌木或小树；纠缠，形势错综复杂
boscage			[n]灌木或树的生长，灌木丛
bosk			[n]一小块有树的地区
chaparral		[n]
coppice			[n]从半树长成的丛林；[v]切断一半让其重新生长
horsewhip		[v]鞭打
leather			[v]用皮毛覆盖；用皮带打
switch			[v]切换状态
whale			[v]猛打
dress down		[v]严厉斥责；穿着时尚
tongue-lash		[v]斥责
call down		[v]批评；使屈尊，使降临
dustup			[n]战斗
moonstruck		[a]受月亮影响的；精神上不平衡的，容易懂感情的，迷失于幻想或白日梦的；
non compos mentis		[a]精神不健全的
pliant			[a]容易受影响的，易屈服的；多用的
paladin			[n]受新人的军事领袖
proponent		[n]拥护者
white knight	[n]拥护一个事业的人
whup			[v]决定性战胜
tidbit			[n]一小口精选的事物；一点令人愉悦的（信息）
kickshaw		[n]非常好吃的东西
gewgaw			[n]华而不实的东西，便宜的小玩意
viand			[n]好吃的东西
incommunicable	
indefinable		
ineffable		
inenarrable		
cheese			[v]停止
cheese it		作为警示危险的用语
clod			
palooka			
odious			
nauseous		
simpleton		[n]头脑简单的人
byname			
cognomen		
moniker			
fiddle away		
fritter (away)	
run through		
trifle (away)	
annuity			[n]养老保险
vaunt			
kvell			
archconservative		
brassbound		
button-down		
hidehound		
mossbacked		
old-line		
paleoconservative		
standpat		
traditionalistic		
ultraconservative		
unprogressive	
check			[n]
circumscription	
trammel			
parmigiana		[n]<<dietetics>>
tease			[v}诱惑却又使之不能得到；通过抓住头发一端把短头发用梳子向头顶推动梳头；通过梳理理清；用起绒草清理衣服；嘲讽；[n]嘲讽者
heckler			
quizzer			
needler			
josh			
jive			
teasel			[n]起绒草；[v]用起绒草清理衣服
bellyache		
yowl			
kvetch			
miserere		
weir			
mere			[n]
excreta			
ordure			
scat			
slops			
chivalrous		
high-minded		
lordly			
sealioning		[n]辩论中使用的骚扰手段，通过问对方误导性的问题以消磨对方的耐心或使其失去理智
arctophile		[n]收集泰迪熊的人
phillumenist	[n]收集火柴盒的人
philatelist		[n]收集古邮票的人
matchbook		
cruciverbalist	[n]善于创造或解决填词游戏的人
vecturist		[n]交通币收集者
exonumia		[n]类似货币但不能当钱使用的标记物
mycophile		[n]热爱采摘可食用野生蘑菇的人
mycology		[n]<<biology>>真菌学
turophile		[n]热爱奶酪的人
oenophile		[n]热爱红酒的人
scripophilist	[n]收集旧文物的人
annus mirabilis	[n]颇有成就的一年
annus horribilis		[n]糟糕的一年
omnibus			[n]能承载很多人的公共汽车
rubicon			[n]不应穿越的界限
in from the cold		从一个艰难时期（如卧底）恢复正常生活
honey trap		引诱物以获取情报
chicken feed	[n]用于获取知情人信任的不重要信息
lamplighter		[n]监督的特工
Moscow rules	用于确保特工会议安全的密码和暗号
espiocrat		[n]高级情报局
confectionary	
retrofit		[v]安装，装饰，增补
parable			
tenor			
shipshape		[a]整齐的
reprise			[n]<<French>><<musical>>乐曲的重复部分；房地产的年费
recapitulation	[n]<<musical>>再现部；<<biology>>重演；概括
ontogeny		[n]<<genetics>>
phylogeny		[n]<<genetics>>
sublingual		[a]<<medical>>舌下的
cozen			
chouse			
chisel			
euchre			
flimflam		
shortchange		
thimblerig		
verve			[n]生机，活跃；精力，能量
gusto			
moxie			
zing			
zip				
vim				
forklift		
apologia		[n]对自己观点的防御
bumper			
fender			
cocoon			
lorica squamata	
Anisakis		
pitcher			[n]大水缸
centenary		
semiotics		
throe			
compatriot		
institution		
mycoplasma		[n]<<medical>>支原体
amok			[adv]暴力疯狂的状态；谋杀一样的疯狂状态
sequester		
exuberant		
extricable		
extrinsic		
factotum		
excerpt			
caucus			
enthrall		
attrition		
hematite		
hematoblast		
epistolary		
engross			
discombobulate	
unrelatable		
fiat			
flabby			
stigma			
hemophilia		
walkout			
contraception	
glaucoma		
ventricle		
botulinum		
gield			
kleptomania		
courtesan		
amaryllis		<<botany>>
hydrangea		
hyacinth		
gladiolus		
dahlia			
azalea			
dogwood			
redbud			
hibiscus		
sage flower		
petunia			
bellflower		
foxglove		
goldenrod		
rhododendron	
forsythia		
glory of the snow		
sweet alyssum	
snapdragon		
magnolia		
camellia		
edelweiss		
belladona		
begonia			<<botany>>
hussy			
bint			
manticore		[n]<<mythology>>
tiller			
wreak			
evermore		
primordinal		
primogeniture	
zander			
coup d'état		[n]<<French>>政变
tannery			[n]制革厂
thunk			
sawbones		
knoll			
flagship		
enthalpy		[n]<<physics>>焓
lacquey			
yore			
jugular			[n]<<medical>>
mangy			
alight			
skit			
charley horse	
taxiway			
flan			[n]<<dietetics>>
tortoiseshell	
camphor			
cockatrice		[n]<<mythology>>
procumbens		
betcha			
gout			
irascible		
bloodshot		
lakeshore		
lilt			
woeful			
orphanage		[n]孤儿院
octave			[n]八度音；八行诗；十四行诗的前八行
mayhap			
slake			
entrails		[n]肠，内脏
whisker			
incipient		
runty			
boozer			[n]酒店
rattrap			
commoner		
senile			
praiseworthy	[a]值得赞颂的
spyglass		
arbalist		
ballista		
swordplay		
stanza			
gratis			
spackle			
swill			
whatsit			
arachis			[n]<<botany>>落花生
emmental		[n]<<dietetics>>瑞士多孔奶酪
nursemaid		[n]育婴女佣
warbler			
stunk			
freebie			[n]赠品
steak au poivre	[n]<<dietetics>><<French>>
cut and dry		
halcyon			
upheavel		
walrus			
trance			
laguna			
pheochromocytoma		[n]<<medical>>嗜铬细胞瘤
statutory		
reindeer		
curandera		
homogamy		[n]<<botany>>雌雄同株
insulinoma		[n]<<medical>>胰岛瘤
cowbane			[n]<<botany>>
dextrose		[n]<<biochemistry>>右旋葡萄糖
affluenza		[n]富贵病
genuflect		
amiodarone		[n]<<chemistry>>
ahold			
luchador		[n]<<Spanish>>
lithotripsy		[n]<<medical>>
nephrology		[n]<<medical>>
holistic		
zonk			
ayahausca		[n]
molly			
polyamory		
sphincter		
pronator		
transvenous		
basilar			
clonus			
ciguatoxin		
torsade			
ampulla			
tympan			
typanum			
paraphasia		
sputum			
versicolor		
cannula			
cannulate		
corpsman		
molluscum contagiosum		
lidocaine		
binge			
cricoid			
lakefront		
bolus			
mordant			
grapevine		
listless		
homebody		
nightlife		
slouch			
troponin		
etomidate		
complementarity	
grit			
tulpa			
grog			
haywire			
nystagmus		[n]<<medical>>
somatic			[a]<<medical>>
reassess		
rhonchi			
diverticulum	
cricothyrotomy	
repress			
orchiotexy		
butane			
mannitol		
ausculation		
anaphylaxis		
worrywart		
ulna			[n]<<anatomy>>尺骨
kairo			
enthansia		[n]安乐死
witticism		
playdate		
cefazolin		
coccyx			[n]<<anatomy>>
fusiform		[a]梭形的
gordita			[a]<<Spanish>>
quandrant		[n]<<mathematics>>象限
patella			[n]<<anatomy>>
reperfusion		
chorioangioma	[n]<<medical>>绒膜血管瘤
mammary			[a]<<biology>>哺乳动物的
falconry		
falcula			
faldstool		
faller			
falling-out		
familism		
famulus			
fanfaronade		
fannings		
far-flung		
farad			[n]<<physics>>电容单位
faradism		[n]
farcie			
fare			
fare-you-well	
frathing		
fascicular		
fasciculus		
fascinator		
fast-fingered	
fatalism		
fathometer		
fawning			
featherbrain	
featheredge		
featherhead		
feathering		
featherpate		
featherpated	
featherweight	
feature-length	
febrifuge		
fecula			
fecundate		
fee-faw-fum		
feed-bottle		[n]奶瓶
feed-tank		[n]给水箱
feedlot			
feedstock		
feedstuff		
feeler			
feelingly		
feldspar		
felicific		
felid			
fell			
feller			
fellmonger		
felo-de-se		
felsite			
feminality		
femineity		
fen				
fencible		
fend			
fenestrate		
fenestration	
Fenian			
fenland			
feoff			
ferdelance		
fermium			[n]<<chemistry>>
ferninst		
ferninster		
ferrate			
ferrety			
ferriage		
ferric			[a]<<chemistry>>含铁离子的
ferricyanide	[n]<<chemistry>>铁氰化物
ferriferous		[a]<<chemistry>>
ferrite			[n]<<chemistry>>
ferrochromium	[n]<<chemistry>>
ferroconcrete	[n]钢筋混凝土
ferromagnetic	[n][a]铁磁体
ferronickel		[n]<<chemistry>>镍铁
ferrophosphorous		[n]<<chemistry>>磷铁
ferrosilicon	[n]<<chemistry>>硅钢
ferrous			[a]<<chemistry>>含亚铁离子的
ferruginous		
ferrule			
ferule			
ferula			
fescennine		
fescue			
festoonery		
festschrift		
fetishism		
fetology		[n]<<medical>>胎儿学
fetor			
feudist			
fevered			
feverish		
fewtrils		
fey				
pullulate		
heartsease		
fictionist		
fictitious		
fiddlehead		
fiddlestick		
fidelism		
fieldpiece		
fieldstrip		
fieldwork		
putsch			[n]试图推翻政府通知的秘密行动计划和突然的行动
booboisie		[n]被政府愚弄的群众
commissar		[n]确保对共产党忠诚度的军事单位
cat's meow		[n]被高度尊重的人或事物
hammer and sickle		[n]共产主义的象征
headshrinker	[n]精神病医生
headhunter		[n]
cover charge	[n]加收的服务费
mimesis			[n]模仿
mimicry			[n]模仿；模仿自然物体的外观以迷惑捕食者
scimitar		
musqueteer		
incommode		
carrotty		


















